AFGHANISTAN = 'AFGHANISTAN',
ÅLAND_ISLANDS = 'ÅLAND ISLANDS',
ALBANIA = 'ALBANIA',
ALGERIA = 'ALGERIA',
AMERICAN_SAMOA = 'AMERICAN SAMOA',
ANDORRA = 'ANDORRA',
ANGOLA = 'ANGOLA',
ANGUILLA = 'ANGUILLA',
ANTARCTICA = 'ANTARCTICA',
ANTIGUA_AND_BARBUDA = 'ANTIGUA AND BARBUDA',
ARGENTINA = 'ARGENTINA',
ARMENIA = 'ARMENIA',
ARUBA = 'ARUBA',
AUSTRALIA = 'AUSTRALIA',
AUSTRIA = 'AUSTRIA',
AZERBAIJAN = 'AZERBAIJAN',
BAHAMAS = 'BAHAMAS',
BAHRAIN = 'BAHRAIN',
BANGLADESH = 'BANGLADESH',
BARBADOS = 'BARBADOS',
BELARUS = 'BELARUS',
BELGIUM = 'BELGIUM',
BELIZE = 'BELIZE',
BENIN = 'BENIN',
BERMUDA = 'BERMUDA',
BHUTAN = 'BHUTAN',
BOLIVIA_(PLURINATIONAL_STATE_OF) = 'BOLIVIA (PLURINATIONAL STATE OF)',
BONAIRE,_SINT_EUSTATIUS_AND_SABA = 'BONAIRE, SINT EUSTATIUS AND SABA',
BOSNIA_AND_HERZEGOVINA = 'BOSNIA AND HERZEGOVINA',
BOTSWANA = 'BOTSWANA',
BOUVET_ISLAND = 'BOUVET ISLAND',
BRAZIL = 'BRAZIL',
BRITISH_INDIAN_OCEAN_TERRITORY = 'BRITISH INDIAN OCEAN TERRITORY',
BRUNEI_DARUSSALAM = 'BRUNEI DARUSSALAM',
BULGARIA = 'BULGARIA',
BURKINA_FASO = 'BURKINA FASO',
BURUNDI = 'BURUNDI',
CABO_VERDE = 'CABO VERDE',
CAMBODIA = 'CAMBODIA',
CAMEROON = 'CAMEROON',
CANADA = 'CANADA',
CAYMAN_ISLANDS = 'CAYMAN ISLANDS',
CENTRAL_AFRICAN_REPUBLIC = 'CENTRAL AFRICAN REPUBLIC',
CHAD = 'CHAD',
CHILE = 'CHILE',
CHINA = 'CHINA',
CHRISTMAS_ISLAND = 'CHRISTMAS ISLAND',
COCOS_(KEELING)_ISLANDS = 'COCOS (KEELING) ISLANDS',
COLOMBIA = 'COLOMBIA',
COMOROS = 'COMOROS',
CONGO = 'CONGO',
CONGO,_DEMOCRATIC_REPUBLIC_OF_THE = 'CONGO, DEMOCRATIC REPUBLIC OF THE',
COOK_ISLANDS = 'COOK ISLANDS',
COSTA_RICA = 'COSTA RICA',
CÔTE_D'IVOIRE = 'CÔTE D'IVOIRE',
CROATIA = 'CROATIA',
CUBA = 'CUBA',
CURAÇAO = 'CURAÇAO',
CYPRUS = 'CYPRUS',
CZECHIA = 'CZECHIA',
DENMARK = 'DENMARK',
DJIBOUTI = 'DJIBOUTI',
DOMINICA = 'DOMINICA',
DOMINICAN_REPUBLIC = 'DOMINICAN REPUBLIC',
ECUADOR = 'ECUADOR',
EGYPT = 'EGYPT',
EL_SALVADOR = 'EL SALVADOR',
EQUATORIAL_GUINEA = 'EQUATORIAL GUINEA',
ERITREA = 'ERITREA',
ESTONIA = 'ESTONIA',
ESWATINI = 'ESWATINI',
ETHIOPIA = 'ETHIOPIA',
FALKLAND_ISLANDS_(MALVINAS) = 'FALKLAND ISLANDS (MALVINAS)',
FAROE_ISLANDS = 'FAROE ISLANDS',
FIJI = 'FIJI',
FINLAND = 'FINLAND',
FRANCE = 'FRANCE',
FRENCH_GUIANA = 'FRENCH GUIANA',
FRENCH_POLYNESIA = 'FRENCH POLYNESIA',
FRENCH_SOUTHERN_TERRITORIES = 'FRENCH SOUTHERN TERRITORIES',
GABON = 'GABON',
GAMBIA = 'GAMBIA',
GEORGIA = 'GEORGIA',
GERMANY = 'GERMANY',
GHANA = 'GHANA',
GIBRALTAR = 'GIBRALTAR',
GREECE = 'GREECE',
GREENLAND = 'GREENLAND',
GRENADA = 'GRENADA',
GUADELOUPE = 'GUADELOUPE',
GUAM = 'GUAM',
GUATEMALA = 'GUATEMALA',
GUERNSEY = 'GUERNSEY',
GUINEA = 'GUINEA',
GUINEA-BISSAU = 'GUINEA-BISSAU',
GUYANA = 'GUYANA',
HAITI = 'HAITI',
HEARD_ISLAND_AND_MCDONALD_ISLANDS = 'HEARD ISLAND AND MCDONALD ISLANDS',
HOLY_SEE = 'HOLY SEE',
HONDURAS = 'HONDURAS',
HONG_KONG = 'HONG KONG',
HUNGARY = 'HUNGARY',
ICELAND = 'ICELAND',
INDIA = 'INDIA',
INDONESIA = 'INDONESIA',
IRAN_(ISLAMIC_REPUBLIC_OF) = 'IRAN (ISLAMIC REPUBLIC OF)',
IRAQ = 'IRAQ',
IRELAND = 'IRELAND',
ISLE_OF_MAN = 'ISLE OF MAN',
ISRAEL = 'ISRAEL',
ITALY = 'ITALY',
JAMAICA = 'JAMAICA',
JAPAN = 'JAPAN',
JERSEY = 'JERSEY',
JORDAN = 'JORDAN',
KAZAKHSTAN = 'KAZAKHSTAN',
KENYA = 'KENYA',
KIRIBATI = 'KIRIBATI',
KOREA_(DEMOCRATIC_PEOPLE'S_REPUBLIC_OF) = 'KOREA (DEMOCRATIC PEOPLE'S REPUBLIC OF)',
KOREA,_REPUBLIC_OF = 'KOREA, REPUBLIC OF',
KUWAIT = 'KUWAIT',
KYRGYZSTAN = 'KYRGYZSTAN',
LAO_PEOPLE'S_DEMOCRATIC_REPUBLIC = 'LAO PEOPLE'S DEMOCRATIC REPUBLIC',
LATVIA = 'LATVIA',
LEBANON = 'LEBANON',
LESOTHO = 'LESOTHO',
LIBERIA = 'LIBERIA',
LIBYA = 'LIBYA',
LIECHTENSTEIN = 'LIECHTENSTEIN',
LITHUANIA = 'LITHUANIA',
LUXEMBOURG = 'LUXEMBOURG',
MACAO = 'MACAO',
MADAGASCAR = 'MADAGASCAR',
MALAWI = 'MALAWI',
MALAYSIA = 'MALAYSIA',
MALDIVES = 'MALDIVES',
MALI = 'MALI',
MALTA = 'MALTA',
MARSHALL_ISLANDS = 'MARSHALL ISLANDS',
MARTINIQUE = 'MARTINIQUE',
MAURITANIA = 'MAURITANIA',
MAURITIUS = 'MAURITIUS',
MAYOTTE = 'MAYOTTE',
MEXICO = 'MEXICO',
MICRONESIA_(FEDERATED_STATES_OF) = 'MICRONESIA (FEDERATED STATES OF)',
MOLDOVA,_REPUBLIC_OF = 'MOLDOVA, REPUBLIC OF',
MONACO = 'MONACO',
MONGOLIA = 'MONGOLIA',
MONTENEGRO = 'MONTENEGRO',
MONTSERRAT = 'MONTSERRAT',
MOROCCO = 'MOROCCO',
MOZAMBIQUE = 'MOZAMBIQUE',
MYANMAR = 'MYANMAR',
NAMIBIA = 'NAMIBIA',
NAURU = 'NAURU',
NEPAL = 'NEPAL',
NETHERLANDS = 'NETHERLANDS',
NEW_CALEDONIA = 'NEW CALEDONIA',
NEW_ZEALAND = 'NEW ZEALAND',
NICARAGUA = 'NICARAGUA',
NIGER = 'NIGER',
NIGERIA = 'NIGERIA',
NIUE = 'NIUE',
NORFOLK_ISLAND = 'NORFOLK ISLAND',
NORTH_MACEDONIA = 'NORTH MACEDONIA',
NORTHERN_MARIANA_ISLANDS = 'NORTHERN MARIANA ISLANDS',
NORWAY = 'NORWAY',
OMAN = 'OMAN',
PAKISTAN = 'PAKISTAN',
PALAU = 'PALAU',
PALESTINE,_STATE_OF = 'PALESTINE, STATE OF',
PANAMA = 'PANAMA',
PAPUA_NEW_GUINEA = 'PAPUA NEW GUINEA',
PARAGUAY = 'PARAGUAY',
PERU = 'PERU',
PHILIPPINES = 'PHILIPPINES',
PITCAIRN = 'PITCAIRN',
POLAND = 'POLAND',
PORTUGAL = 'PORTUGAL',
PUERTO_RICO = 'PUERTO RICO',
QATAR = 'QATAR',
RÉUNION = 'RÉUNION',
ROMANIA = 'ROMANIA',
RUSSIAN_FEDERATION = 'RUSSIAN FEDERATION',
RWANDA = 'RWANDA',
SAINT_BARTHÉLEMY = 'SAINT BARTHÉLEMY',
SAINT_HELENA,_ASCENSION_AND_TRISTAN_DA_CUNHA = 'SAINT HELENA, ASCENSION AND TRISTAN DA CUNHA',
SAINT_KITTS_AND_NEVIS = 'SAINT KITTS AND NEVIS',
SAINT_LUCIA = 'SAINT LUCIA',
SAINT_MARTIN_(FRENCH_PART) = 'SAINT MARTIN (FRENCH PART)',
SAINT_PIERRE_AND_MIQUELON = 'SAINT PIERRE AND MIQUELON',
SAINT_VINCENT_AND_THE_GRENADINES = 'SAINT VINCENT AND THE GRENADINES',
SAMOA = 'SAMOA',
SAN_MARINO = 'SAN MARINO',
SAO_TOME_AND_PRINCIPE = 'SAO TOME AND PRINCIPE',
SAUDI_ARABIA = 'SAUDI ARABIA',
SENEGAL = 'SENEGAL',
SERBIA = 'SERBIA',
SEYCHELLES = 'SEYCHELLES',
SIERRA_LEONE = 'SIERRA LEONE',
SINGAPORE = 'SINGAPORE',
SINT_MAARTEN_(DUTCH_PART) = 'SINT MAARTEN (DUTCH PART)',
SLOVAKIA = 'SLOVAKIA',
SLOVENIA = 'SLOVENIA',
SOLOMON_ISLANDS = 'SOLOMON ISLANDS',
SOMALIA = 'SOMALIA',
SOUTH_AFRICA = 'SOUTH AFRICA',
SOUTH_GEORGIA_AND_THE_SOUTH_SANDWICH_ISLANDS = 'SOUTH GEORGIA AND THE SOUTH SANDWICH ISLANDS',
SOUTH_SUDAN = 'SOUTH SUDAN',
SPAIN = 'SPAIN',
SRI_LANKA = 'SRI LANKA',
SUDAN = 'SUDAN',
SURINAME = 'SURINAME',
SVALBARD_AND_JAN_MAYEN = 'SVALBARD AND JAN MAYEN',
SWEDEN = 'SWEDEN',
SWITZERLAND = 'SWITZERLAND',
SYRIAN_ARAB_REPUBLIC = 'SYRIAN ARAB REPUBLIC',
TAIWAN,_PROVINCE_OF_CHINA = 'TAIWAN, PROVINCE OF CHINA',
TAJIKISTAN = 'TAJIKISTAN',
TANZANIA,_UNITED_REPUBLIC_OF = 'TANZANIA, UNITED REPUBLIC OF',
THAILAND = 'THAILAND',
TIMOR-LESTE = 'TIMOR-LESTE',
TOGO = 'TOGO',
TOKELAU = 'TOKELAU',
TONGA = 'TONGA',
TRINIDAD_AND_TOBAGO = 'TRINIDAD AND TOBAGO',
TUNISIA = 'TUNISIA',
TURKEY = 'TURKEY',
TURKMENISTAN = 'TURKMENISTAN',
TURKS_AND_CAICOS_ISLANDS = 'TURKS AND CAICOS ISLANDS',
TUVALU = 'TUVALU',
UGANDA = 'UGANDA',
UKRAINE = 'UKRAINE',
UNITED_ARAB_EMIRATES = 'UNITED ARAB EMIRATES',
UNITED_KINGDOM_OF_GREAT_BRITAIN_AND_NORTHERN_IRELAND = 'UNITED KINGDOM OF GREAT BRITAIN AND NORTHERN IRELAND',
UNITED_STATES_OF_AMERICA = 'UNITED STATES OF AMERICA',
UNITED_STATES_MINOR_OUTLYING_ISLANDS = 'UNITED STATES MINOR OUTLYING ISLANDS',
URUGUAY = 'URUGUAY',
UZBEKISTAN = 'UZBEKISTAN',
VANUATU = 'VANUATU',
VENEZUELA_(BOLIVARIAN_REPUBLIC_OF) = 'VENEZUELA (BOLIVARIAN REPUBLIC OF)',
VIET_NAM = 'VIET NAM',
VIRGIN_ISLANDS_(BRITISH) = 'VIRGIN ISLANDS (BRITISH)',
VIRGIN_ISLANDS_(U.S.) = 'VIRGIN ISLANDS (U.S.)',
WALLIS_AND_FUTUNA = 'WALLIS AND FUTUNA',
WESTERN_SAHARA = 'WESTERN SAHARA',
YEMEN = 'YEMEN',
ZAMBIA = 'ZAMBIA',
ZIMBABWE = 'ZIMBABWE',
