AMTALI = "AMTALI",
BAMNA = "BAMNA",
BARGUNA SADAR = "BARGUNA SADAR",
NALI BANDAR = "NALI BANDAR",
BETAGI = "BETAGI",
DARUL ULAM = "DARUL ULAM",
KAKCHIRA = "KAKCHIRA",
PATHARGHATA = "PATHARGHATA",
AGAILZHARA = "AGAILZHARA",
GAILA = "GAILA",
PAISARHAT = "PAISARHAT",
BABUGANJ = "BABUGANJ",
BARISAL CADET = "BARISAL CADET",
CHANDPASHA = "CHANDPASHA",
MADHABPASHA = "MADHABPASHA",
NIZAMUDDIN COLLEGE = "NIZAMUDDIN COLLEGE",
RAHAMATPUR = "RAHAMATPUR",
THAKUR MALLIK = "THAKUR MALLIK",
BARAJALIA = "BARAJALIA",
OSMAN MANJIL = "OSMAN MANJIL",
BARISAL SADAR = "BARISAL SADAR",
BUKHAINAGAR = "BUKHAINAGAR",
JAGUARHAT = "JAGUARHAT",
KASHIPUR = "KASHIPUR",
PATANG = "PATANG",
SAHEBERHAT = "SAHEBERHAT",
SUGANDIA = "SUGANDIA",
BATAJOR = "BATAJOR",
GOURANADI = "GOURANADI",
KASHEMABAD = "KASHEMABAD",
TARKI BANDAR = "TARKI BANDAR",
LANGUTIA = "LANGUTIA",
LASKARPUR = "LASKARPUR",
MAHENDIGANJ = "MAHENDIGANJ",
NALGORA = "NALGORA",
ULANIA = "ULANIA",
CHARKALEKHAN = "CHARKALEKHAN",
KAZIRCHAR = "KAZIRCHAR",
MULADI = "MULADI",
CHARAMANDI = "CHARAMANDI",
KALASKATI = "KALASKATI",
PADRI SHIBPUR = "PADRI SHIBPUR",
SAHEBGANJ = "SAHEBGANJ",
SHIALGUNI = "SHIALGUNI",
DAKUARHAT = "DAKUARHAT",
DHAMURA = "DHAMURA",
JUGIRKANDA = "JUGIRKANDA",
SHIKARPUR = "SHIKARPUR",
UZIRPUR = "UZIRPUR",
BHOLA SADAR = "BHOLA SADAR",
JOYNAGAR = "JOYNAGAR",
BORHANUDDIN UPO = "BORHANUDDIN UPO",
MIRZAKALU = "MIRZAKALU",
CHARFASHION = "CHARFASHION",
DULARHAT = "DULARHAT",
KERAMATGANJ = "KERAMATGANJ",
DOULATKHAN = "DOULATKHAN",
HAJIPUR = "HAJIPUR",
HAJIRHAT = "HAJIRHAT",
HATSHOSHIGANJ = "HATSHOSHIGANJ",
DAURIHAT = "DAURIHAT",
GAZARIA = "GAZARIA",
LALMOHAN UPO = "LALMOHAN UPO",
BAUKATHI = "BAUKATHI",
GABHA = "GABHA",
JHALOKATHI SADAR = "JHALOKATHI SADAR",
NABAGRAM = "NABAGRAM",
SHEKHERHAT = "SHEKHERHAT",
AMUA = "AMUA",
KATHALIA = "KATHALIA",
NIAMATEE = "NIAMATEE",
SHOULAJALIA = "SHOULAJALIA",
BEERKATHI = "BEERKATHI",
NALCHHITI = "NALCHHITI",
RAJAPUR = "RAJAPUR",
BAGABANDAR = "BAGABANDAR",
BAUPHAL = "BAUPHAL",
BIRPASHA = "BIRPASHA",
KALAIA = "KALAIA",
KALISHARI = "KALISHARI",
DASHMINA = "DASHMINA",
GALACHIPA = "GALACHIPA",
GAZIPUR BANDAR = "GAZIPUR BANDAR",
KHEPUPARA = "KHEPUPARA",
MAHIPUR = "MAHIPUR",
DUMKEE = "DUMKEE",
MOUKARAN = "MOUKARAN",
PATUAKHALI SADAR = "PATUAKHALI SADAR",
RAHIMABAD = "RAHIMABAD",
SUBIDKHALI = "SUBIDKHALI",
BANARIPARA = "BANARIPARA",
CHAKHAR = "CHAKHAR",
BHANDARIA = "BHANDARIA",
DHAOA = "DHAOA",
KANUDASHKATHI = "KANUDASHKATHI",
JOLAGATI = "JOLAGATI",
JOYKUL = "JOYKUL",
KAUKHALI = "KAUKHALI",
KEUNDIA = "KEUNDIA",
BETMOR NATUN HAT = "BETMOR NATUN HAT",
GULISHAKHALI = "GULISHAKHALI",
HALTA = "HALTA",
MATHBARIA = "MATHBARIA",
SHILARGANJ = "SHILARGANJ",
TIARKHALI = "TIARKHALI",
TUSHKHALI = "TUSHKHALI",
NAZIRPUR = "NAZIRPUR",
SRIRAMKATHI = "SRIRAMKATHI",
HULARHAT = "HULARHAT",
PARERHAT = "PARERHAT",
PIROJPUR SADAR = "PIROJPUR SADAR",
DARUS SUNNAT = "DARUS SUNNAT",
JALABARI = "JALABARI",
KAURIKHARA = "KAURIKHARA",
SWARUPKATHI = "SWARUPKATHI",
ALIKADAM = "ALIKADAM",
BANDARBAN SADAR = "BANDARBAN SADAR",
NAIKHONG = "NAIKHONG",
ROANCHHARI = "ROANCHHARI",
RUMA = "RUMA",
LAMA = "LAMA",
THANCHI = "THANCHI",
AKHAURA = "AKHAURA",
AZAMPUR = "AZAMPUR",
GANGASAGAR = "GANGASAGAR",
BANCHHARAMPUR = "BANCHHARAMPUR",
ASHUGANJ = "ASHUGANJ",
ASHUGANJ SHARE = "ASHUGANJ SHARE",
BRAHAMANBARIA SADAR = "BRAHAMANBARIA SADAR",
POUN = "POUN",
TALSHAHAR = "TALSHAHAR",
CHANDIDAR = "CHANDIDAR",
CHARGACHH = "CHARGACHH",
GOPINATHPUR = "GOPINATHPUR",
KASBA = "KASBA",
KUTI = "KUTI",
JIBANGANJ = "JIBANGANJ",
KAITALA = "KAITALA",
LAUBFATEHPUR = "LAUBFATEHPUR",
NABINAGAR = "NABINAGAR",
RASULLABAD = "RASULLABAD",
RATANPUR = "RATANPUR",
SALIMGANJ = "SALIMGANJ",
SHAHAPUR = "SHAHAPUR",
SHAMGRAM = "SHAMGRAM",
FANDAUK = "FANDAUK",
NASIRNAGAR = "NASIRNAGAR",
CHANDURA = "CHANDURA",
SARIAL = "SARIAL",
SHAHBAJPUR = "SHAHBAJPUR",
BABURHAT = "BABURHAT",
CHANDPUR SADAR = "CHANDPUR SADAR",
PURANBAZAR = "PURANBAZAR",
SAHATALI = "SAHATALI",
CHANDRA = "CHANDRA",
FARIDGANJ = "FARIDGANJ",
GRIDKALIANDIA = "GRIDKALIANDIA",
ISLAMPUR SHAH ISAIN = "ISLAMPUR SHAH ISAIN",
RAMPURBAZAR = "RAMPURBAZAR",
RUPSHA = "RUPSHA",
BOLAKHAL = "BOLAKHAL",
HAJIGANJ = "HAJIGANJ",
GANDAMARA = "GANDAMARA",
HAYEMCHAR = "HAYEMCHAR",
KACHUA = "KACHUA",
PAK SHRIRAMPUR = "PAK SHRIRAMPUR",
RAHIMA NAGAR = "RAHIMA NAGAR",
SHACHAR = "SHACHAR",
KALIPUR = "KALIPUR",
MATLOBGANJ = "MATLOBGANJ",
MOHANPUR = "MOHANPUR",
CHOTOSHI = "CHOTOSHI",
ISLAMIA MADRASHA = "ISLAMIA MADRASHA",
KHILABAZAR = "KHILABAZAR",
PASHCHIM KHERIHAR AL = "PASHCHIM KHERIHAR AL",
SHAHRASTI = "SHAHRASTI",
ANOWARA = "ANOWARA",
BATTALI = "BATTALI",
PAROIKORA = "PAROIKORA",
BOALKHALI = "BOALKHALI",
CHARANDWIP = "CHARANDWIP",
IQBAL PARK = "IQBAL PARK",
KADURKHAL = "KADURKHAL",
KANUNGOPARA = "KANUNGOPARA",
SAKPURA = "SAKPURA",
SAROATOLI = "SAROATOLI",
AL- AMIN BARIA MADRA = "AL- AMIN BARIA MADRA",
AMIN JUTE MILLS = "AMIN JUTE MILLS",
ANANDABAZAR = "ANANDABAZAR",
BAYEZID BOSTAMI = "BAYEZID BOSTAMI",
CHANDGAON = "CHANDGAON",
CHAWKBAZAR = "CHAWKBAZAR",
CHITT. CANTONMENT = "CHITT. CANTONMENT",
CHITT. CUSTOMS ACCA = "CHITT. CUSTOMS ACCA",
CHITT. POLITECHNIC IN = "CHITT. POLITECHNIC IN",
CHITT. SAILERS COLON = "CHITT. SAILERS COLON",
CHITTAGONG AIRPORT = "CHITTAGONG AIRPORT",
CHITTAGONG BANDAR = "CHITTAGONG BANDAR",
CHITTAGONG GPO = "CHITTAGONG GPO",
EXPORT PROCESSING = "EXPORT PROCESSING",
FIROZSHAH = "FIROZSHAH",
HALISHAHAR = "HALISHAHAR",
HALISHSHAR = "HALISHSHAR",
JALALABAD = "JALALABAD",
JALDIA MERINE ACCADE = "JALDIA MERINE ACCADE",
MIDDLE PATENGA = "MIDDLE PATENGA",
MOHARD = "MOHARD",
NORTH HALISHAHAR = "NORTH HALISHAHAR",
NORTH KATULI = "NORTH KATULI",
PAHARTOLI = "PAHARTOLI",
PATENGA = "PATENGA",
RAMPURA TSO = "RAMPURA TSO",
WAZEDIA = "WAZEDIA",
BARMA = "BARMA",
DOHAZARI = "DOHAZARI",
EAST JOARA = "EAST JOARA",
GACHBARIA = "GACHBARIA",
BHANDAR SHARIF = "BHANDAR SHARIF",
FATIKCHHARI = "FATIKCHHARI",
HARUALCHHARI = "HARUALCHHARI",
NAJIRHAT = "NAJIRHAT",
NANUPUR = "NANUPUR",
NARAYANHAT = "NARAYANHAT",
CHITT.UNIVERSITY = "CHITT.UNIVERSITY",
FATAHABAD = "FATAHABAD",
GORDUARA = "GORDUARA",
HATHAZARI = "HATHAZARI",
KATIRHAT = "KATIRHAT",
MADRASA = "MADRASA",
MIRZAPUR = "MIRZAPUR",
NURALIBARI = "NURALIBARI",
YUNUS NAGAR = "YUNUS NAGAR",
BANIGRAM = "BANIGRAM",
GUNAGARI = "GUNAGARI",
JALDI = "JALDI",
KHAN BAHADUR = "KHAN BAHADUR",
CHUNTI = "CHUNTI",
LOHAGARA = "LOHAGARA",
PADUA = "PADUA",
ABUTORAB = "ABUTORAB",
AZAMPUR = "AZAMPUR",
BHARAWAZHAT = "BHARAWAZHAT",
DARROGAHAT = "DARROGAHAT",
JOARGANJ = "JOARGANJ",
KORERHAT = "KORERHAT",
MIRSHARAI = "MIRSHARAI",
MOHAZANHAT = "MOHAZANHAT",
BUDHPARA = "BUDHPARA",
PATIYA HEAD OFFICE = "PATIYA HEAD OFFICE",
DHAMAIR = "DHAMAIR",
RANGUNIA = "RANGUNIA",
B.I.T POST OFFICE = "B.I.T POST OFFICE",
BEENAJURI = "BEENAJURI",
DEWANPUR = "DEWANPUR",
FATEPUR = "FATEPUR",
GAHIRA = "GAHIRA",
GUZRA NOAPARA = "GUZRA NOAPARA",
JAGANNATH HAT = "JAGANNATH HAT",
KUNDESHWARI = "KUNDESHWARI",
MOHAMUNI = "MOHAMUNI",
ROUZAN = "ROUZAN",
SANDWIP = "SANDWIP",
SHIBERHAT = "SHIBERHAT",
URIRCHAR = "URIRCHAR",
BAITUL IJJAT = "BAITUL IJJAT",
BAZALIA = "BAZALIA",
SATKANIA = "SATKANIA",
BARABKUNDA = "BARABKUNDA",
BAROIDHALA = "BAROIDHALA",
BAWASHBARIA = "BAWASHBARIA",
BHATIARI = "BHATIARI",
FOUZDARHAT = "FOUZDARHAT",
JAFRABAD = "JAFRABAD",
KUMIRA = "KUMIRA",
SITAKUNDA = "SITAKUNDA",
BARURA = "BARURA",
MURDAFARGANJ = "MURDAFARGANJ",
POYALGACHHA = "POYALGACHHA",
BRAHMANPARA = "BRAHMANPARA",
BURICHANG = "BURICHANG",
MAYNAMOTI BAZAR = "MAYNAMOTI BAZAR",
CHANDIA = "CHANDIA",
MADHAIABAZAR = "MADHAIABAZAR",
BATISA = "BATISA",
CHIORA = "CHIORA",
CHOUDDAGRAM = "CHOUDDAGRAM",
COMILLA CONTOMENT = "COMILLA CONTOMENT",
COMILLA SADAR = "COMILLA SADAR",
COURTBARI = "COURTBARI",
HALIMANAGAR = "HALIMANAGAR",
SUAGANJ = "SUAGANJ",
DASHPARA = "DASHPARA",
DAUDKANDI = "DAUDKANDI",
ELIOTGANJ = "ELIOTGANJ",
GOURIPUR = "GOURIPUR",
BARASHALGHAR = "BARASHALGHAR",
DAVIDHAR = "DAVIDHAR",
DHAMTEE = "DHAMTEE",
GANGAMANDAL = "GANGAMANDAL",
HOMNA = "HOMNA",
BIPULASAR = "BIPULASAR",
LAKSAM = "LAKSAM",
LAKSHAMANPUR = "LAKSHAMANPUR",
CHHARIABAZAR = "CHHARIABAZAR",
DHALUA = "DHALUA",
GUNABATI = "GUNABATI",
LANGALKOT = "LANGALKOT",
BANGRA = "BANGRA",
COMPANYGANJ = "COMPANYGANJ",
MURADNAGAR = "MURADNAGAR",
PANTIBAZAR = "PANTIBAZAR",
RAMCHANDARPUR = "RAMCHANDARPUR",
SONAKANDA = "SONAKANDA",
BADARKALI = "BADARKALI",
CHIRINGGA = "CHIRINGGA",
CHIRINGGA S.O = "CHIRINGGA S.O",
MALUMGHAT = "MALUMGHAT",
COXS BAZAR SADAR = "COXS BAZAR SADAR",
EIDGA = "EIDGA",
ZHILANJA = "ZHILANJA",
GORAKGHAT = "GORAKGHAT",
KUTUBDIA = "KUTUBDIA",
RAMU = "RAMU",
HNILA = "HNILA",
ST.MARTIN = "ST.MARTIN",
TEKNAF = "TEKNAF",
UKHIA = "UKHIA",
CHHAGALNAIA = "CHHAGALNAIA",
DARAGA HAT = "DARAGA HAT",
MAHARAJGANJ = "MAHARAJGANJ",
PUABASHIMULIA = "PUABASHIMULIA",
CHHILONIA = "CHHILONIA",
DAGONDHUIA = "DAGONDHUIA",
DUDMUKHA = "DUDMUKHA",
RAJAPUR = "RAJAPUR",
FAZILPUR = "FAZILPUR",
FENI SADAR = "FENI SADAR",
LASKARHAT = "LASKARHAT",
SHARSHADIE = "SHARSHADIE",
FULGAZI = "FULGAZI",
MUNSHIRHAT = "MUNSHIRHAT",
PASHURAMPUR = "PASHURAMPUR",
SHUARBAZAR = "SHUARBAZAR",
AHMADPUR = "AHMADPUR",
KAZIRHAT = "KAZIRHAT",
MOTIGANJ = "MOTIGANJ",
SONAGAZI = "SONAGAZI",
DIGINALA = "DIGINALA",
KHAGRACHARI SADAR = "KHAGRACHARI SADAR",
LAXMICHHARI = "LAXMICHHARI",
MAHALCHHARI = "MAHALCHHARI",
MANIKCHHARI = "MANIKCHHARI",
MATIRANGA = "MATIRANGA",
PANCHHARI = "PANCHHARI",
RAMGHAR HEAD OFFICE = "RAMGHAR HEAD OFFICE",
CHAR ALEXGANDER = "CHAR ALEXGANDER",
HAJIRGHAT = "HAJIRGHAT",
RAMGATIRHAT = "RAMGATIRHAT",
AMANI LAKSHIMPUR = "AMANI LAKSHIMPUR",
BHABANIGANJ = "BHABANIGANJ",
CHANDRAGANJ = "CHANDRAGANJ",
CHOUPALLI = "CHOUPALLI",
DALAL BAZAR = "DALAL BAZAR",
DUTTAPARA = "DUTTAPARA",
KERAMATGANJ = "KERAMATGANJ",
LAKSHIMPUR SADAR = "LAKSHIMPUR SADAR",
MANDARI = "MANDARI",
RUPCHARA = "RUPCHARA",
ALIPUR = "ALIPUR",
DOLTA = "DOLTA",
KANCHANPUR = "KANCHANPUR",
NAAGMUD = "NAAGMUD",
PANPARA = "PANPARA",
RAMGANJ = "RAMGANJ",
BHUABARI = "BHUABARI",
HAYDARGANJ = "HAYDARGANJ",
NAGERDIGHIRPAR = "NAGERDIGHIRPAR",
RAKHALLIA = "RAKHALLIA",
RAYPUR = "RAYPUR",
BASUR HAT = "BASUR HAT",
CHARHAJARI = "CHARHAJARI",
ALAIARPUR = "ALAIARPUR",
AMISHA PARA = "AMISHA PARA",
BANGLABAZAR = "BANGLABAZAR",
BAZRA = "BAZRA",
BEGUMGANJ = "BEGUMGANJ",
BHABANI JIBANPUR = "BHABANI JIBANPUR",
CHOUMOHANI = "CHOUMOHANI",
DAUTI = "DAUTI",
DURGAPUR = "DURGAPUR",
GOPALPUR = "GOPALPUR",
JAMIDAR HAT = "JAMIDAR HAT",
JOYAG = "JOYAG",
JOYNARAYANPUR = "JOYNARAYANPUR",
KHALAFAT BAZAR = "KHALAFAT BAZAR",
KHALISHPUR = "KHALISHPUR",
MAHESHGANJ = "MAHESHGANJ",
MIR OWARISHPUR = "MIR OWARISHPUR",
NADONA = "NADONA",
NANDIAPARA = "NANDIAPARA",
OACHHEKPUR = "OACHHEKPUR",
RAJGANJ = "RAJGANJ",
SONAIMURI = "SONAIMURI",
TANGIRPAR = "TANGIRPAR",
THANAR HAT = "THANAR HAT",
BANSA BAZAR = "BANSA BAZAR",
BODALCOURT = "BODALCOURT",
CHATKHIL = "CHATKHIL",
DOSH GHARIA = "DOSH GHARIA",
KARIHATI = "KARIHATI",
KHILPARA = "KHILPARA",
PALLA = "PALLA",
REZZAKPUR = "REZZAKPUR",
SAHAPUR = "SAHAPUR",
SAMPARA = "SAMPARA",
SHINGBAHURA = "SHINGBAHURA",
SOLLA = "SOLLA",
AFAZIA = "AFAZIA",
HATIYA = "HATIYA",
TAMORADDI = "TAMORADDI",
CHAPRASHIR HAT = "CHAPRASHIR HAT",
CHAR JABBAR = "CHAR JABBAR",
CHARAM TUA = "CHARAM TUA",
DIN MONIR HAT = "DIN MONIR HAT",
KABIRHAT = "KABIRHAT",
KHALIFAR HAT = "KHALIFAR HAT",
MRIDDARHAT = "MRIDDARHAT",
NOAKHALI COLLEGE = "NOAKHALI COLLEGE",
NOAKHALI SADAR = "NOAKHALI SADAR",
PAK KISHOREGANJ = "PAK KISHOREGANJ",
SONAPUR = "SONAPUR",
BEEZBAG = "BEEZBAG",
CHATARPAIA = "CHATARPAIA",
KALLYANDI = "KALLYANDI",
KANKIRHAT = "KANKIRHAT",
SENBAG = "SENBAG",
T.P. LAMUA = "T.P. LAMUA",
BARAKAL = "BARAKAL",
BILAICHHARI = "BILAICHHARI",
JARACHHARI = "JARACHHARI",
BETBUNIA = "BETBUNIA",
KALAMPATI = "KALAMPATI",
CHANDRAGHONA = "CHANDRAGHONA",
KAPTAI = "KAPTAI",
KAPTAI NUTON BAZAR = "KAPTAI NUTON BAZAR",
KAPTAI PROJECT = "KAPTAI PROJECT",
LONGACHH = "LONGACHH",
MARISHYA = "MARISHYA",
NANICHHAR = "NANICHHAR",
RAJSTHALI = "RAJSTHALI",
RANGAMATI SADAR = "RANGAMATI SADAR",
DEMRA = "DEMRA",
MATUAIL = "MATUAIL",
SARULIA = "SARULIA",
DHAKA CANTONMENTTSO = "DHAKA CANTONMENTTSO",
DHAMRAI = "DHAMRAI",
KAMALPUR = "KAMALPUR",
JIGATALA TSO = "JIGATALA TSO",
BANANI TSO = "BANANI TSO",
GULSHAN MODEL TOWN = "GULSHAN MODEL TOWN",
DHANIA TSO = "DHANIA TSO",
JOYPARA = "JOYPARA",
NARISHA = "NARISHA",
PALAMGANJ = "PALAMGANJ",
ATI = "ATI",
DHAKA JUTE MILLS = "DHAKA JUTE MILLS",
KALATIA = "KALATIA",
KERANIGANJ = "KERANIGANJ",
KHILGAONTSO = "KHILGAONTSO",
KHILKHETTSO = "KHILKHETTSO",
POSTA TSO = "POSTA TSO",
MIRPUR TSO = "MIRPUR TSO",
MOHAMMADPUR HOUSING = "MOHAMMADPUR HOUSING",
SANGSAD BHABANTSO = "SANGSAD BHABANTSO",
BANGABHABANTSO = "BANGABHABANTSO",
DILKUSHATSO = "DILKUSHATSO",
AGLA = "AGLA",
CHURAIN = "CHURAIN",
DAUDPUR = "DAUDPUR",
HASNABAD = "HASNABAD",
KHALPAR = "KHALPAR",
NAWABGANJ = "NAWABGANJ",
NEW MARKET TSO = "NEW MARKET TSO",
DHAKA GPO = "DHAKA GPO",
SHANTINAGR TSO = "SHANTINAGR TSO",
BASABO TSO = "BASABO TSO",
AMIN BAZAR = "AMIN BAZAR",
DAIRY FARM = "DAIRY FARM",
EPZ = "EPZ",
JAHANGIRNAGAR UNIVER = "JAHANGIRNAGAR UNIVER",
KASHEM COTTON MILLS = "KASHEM COTTON MILLS",
RAJPHULBARIA = "RAJPHULBARIA",
SAVAR = "SAVAR",
SAVAR CANTTONMENT = "SAVAR CANTTONMENT",
SAVER P.A.T.C = "SAVER P.A.T.C",
SHIMULIA = "SHIMULIA",
DHAKA SADAR HO = "DHAKA SADAR HO",
GENDARIA TSO = "GENDARIA TSO",
WARI TSO = "WARI TSO",
TEJGAON TSO = "TEJGAON TSO",
DHAKA POLITECHNIC = "DHAKA POLITECHNIC",
UTTARA MODEL TWONTSO = "UTTARA MODEL TWONTSO",
ALFADANGA = "ALFADANGA",
BHANGA = "BHANGA",
BOALMARI = "BOALMARI",
RUPATPAT = "RUPATPAT",
CHARBADRASHAN = "CHARBADRASHAN",
AMBIKAPUR = "AMBIKAPUR",
BAITULAMAN POLITECNI = "BAITULAMAN POLITECNI",
FARIDPURSADAR = "FARIDPURSADAR",
KANAIPUR = "KANAIPUR",
KAMARKALI = "KAMARKALI",
MADUKHALI = "MADUKHALI",
NAGARKANDA = "NAGARKANDA",
TALMA = "TALMA",
BISHWA JAKER MANJIL = "BISHWA JAKER MANJIL",
HAT KRISHAPUR = "HAT KRISHAPUR",
SADARPUR = "SADARPUR",
SHRIANGAN = "SHRIANGAN",
B.O.F = "B.O.F",
B.R.R = "B.R.R",
CHANDNA = "CHANDNA",
GAZIPUR SADAR = "GAZIPUR SADAR",
NATIONAL UNIVERSITY = "NATIONAL UNIVERSITY",
KALIAKAAR = "KALIAKAAR",
SAFIPUR = "SAFIPUR",
KALIGANJ = "KALIGANJ",
PUBAIL = "PUBAIL",
SANTANPARA = "SANTANPARA",
VAOAL JAMALPUR = "VAOAL JAMALPUR",
KAPASHIA = "KAPASHIA",
ERSHAD NAGAR = "ERSHAD NAGAR",
MONNUNAGAR = "MONNUNAGAR",
NISHAT NAGAR = "NISHAT NAGAR",
BARMI = "BARMI",
BASHAMUR = "BASHAMUR",
BOUBI = "BOUBI",
KAWRAID = "KAWRAID",
SATKHAMAIR = "SATKHAMAIR",
SREEPUR = "SREEPUR",
RAJENDRAPUR = "RAJENDRAPUR",
RAJENDRAPUR CANTTOME = "RAJENDRAPUR CANTTOME",
BARFA = "BARFA",
CHANDRADIGHALIA = "CHANDRADIGHALIA",
GOPALGANJ SADAR = "GOPALGANJ SADAR",
ULPUR = "ULPUR",
JONAPUR = "JONAPUR",
KASHIANI = "KASHIANI",
RAMDIA COLLEGE = "RAMDIA COLLEGE",
RATOIL = "RATOIL",
KOTALIPARA = "KOTALIPARA",
BATKIAMARI = "BATKIAMARI",
KHANDARPARA = "KHANDARPARA",
MAKSUDPUR = "MAKSUDPUR",
PATGATI = "PATGATI",
TUNGIPARA = "TUNGIPARA",
DEWANGONJ = "DEWANGONJ",
DEWANGONJ S. MILLS = "DEWANGONJ S. MILLS",
DURMOOT = "DURMOOT",
GILABARI = "GILABARI",
ISLAMPUR = "ISLAMPUR",
JAMALPUR = "JAMALPUR",
NANDINA = "NANDINA",
NARUNDI = "NARUNDI",
JAMALPUR = "JAMALPUR",
MAHMOODPUR = "MAHMOODPUR",
MALANCHA = "MALANCHA",
MALANDAH = "MALANDAH",
BALIJHURI = "BALIJHURI",
MATHARGONJ = "MATHARGONJ",
BAUSEE = "BAUSEE",
GUNERBARI = "GUNERBARI",
JAGANNATH GHAT = "JAGANNATH GHAT",
JAMUNA SAR KARKHANA = "JAMUNA SAR KARKHANA",
PINGNA = "PINGNA",
SHORISHABARI = "SHORISHABARI",
BAJITPUR = "BAJITPUR",
LAKSMIPUR = "LAKSMIPUR",
SARARCHAR = "SARARCHAR",
BHAIRAB = "BHAIRAB",
HOSSENPUR = "HOSSENPUR",
ITNA = "ITNA",
KARIMGANJ = "KARIMGANJ",
GOCHHIHATA = "GOCHHIHATA",
KATIADI = "KATIADI",
KISHOREGANJ S.MILLS = "KISHOREGANJ S.MILLS",
KISHOREGANJ SADAR = "KISHOREGANJ SADAR",
MAIZHATI = "MAIZHATI",
NILGANJ = "NILGANJ",
CHHOYSUTI = "CHHOYSUTI",
KULIARCHAR = "KULIARCHAR",
ABDULLAHPUR = "ABDULLAHPUR",
MITHAMOIN = "MITHAMOIN",
NIKLI = "NIKLI",
OSTAGRAM = "OSTAGRAM",
PAKUNDIA = "PAKUNDIA",
TARIAL = "TARIAL",
BAHADURPUR = "BAHADURPUR",
BARHAMGANJ = "BARHAMGANJ",
NILAKSMIBANDAR = "NILAKSMIBANDAR",
UMEDPUR = "UMEDPUR",
KALKINI = "KALKINI",
SAHABRAMPUR = "SAHABRAMPUR",
CHARMUGRIA = "CHARMUGRIA",
HABIGANJ = "HABIGANJ",
KULPADDI = "KULPADDI",
MADARIPUR SADAR = "MADARIPUR SADAR",
MUSTAFAPUR = "MUSTAFAPUR",
KHALIA = "KHALIA",
RAJOIR = "RAJOIR",
DOULATPUR = "DOULATPUR",
GHEOR = "GHEOR",
JHITKA = "JHITKA",
LECHHRAGANJ = "LECHHRAGANJ",
BARANGAIL = "BARANGAIL",
GORPARA = "GORPARA",
MAHADEBPUR = "MAHADEBPUR",
MANIKGANJ BAZAR = "MANIKGANJ BAZAR",
MANIKGANJ SADAR = "MANIKGANJ SADAR",
BALIATI = "BALIATI",
SATURIA = "SATURIA",
ARICHA = "ARICHA",
SHIBALOY = "SHIBALOY",
TEWTA = "TEWTA",
UTHLI = "UTHLI",
BAIRA = "BAIRA",
JOYMANTOP = "JOYMANTOP",
SINGAIR = "SINGAIR",
GAJARIA = "GAJARIA",
HOSSENDI = "HOSSENDI",
RASULPUR = "RASULPUR",
GOURAGONJ = "GOURAGONJ",
GOURAGONJ = "GOURAGONJ",
HALDIA SO = "HALDIA SO",
HARIDIA = "HARIDIA",
HARIDIA DESO = "HARIDIA DESO",
KORHATI = "KORHATI",
LOHAJANG = "LOHAJANG",
MADINI MANDAL = "MADINI MANDAL",
MEDINI MANDAL EDSO = "MEDINI MANDAL EDSO",
KATHAKHALI = "KATHAKHALI",
MIRKADIM = "MIRKADIM",
MUNSHIGANJ SADAR = "MUNSHIGANJ SADAR",
RIKABIBAZAR = "RIKABIBAZAR",
ICHAPUR = "ICHAPUR",
KOLA = "KOLA",
MALKHA NAGAR = "MALKHA NAGAR",
SHEKHER NAGAR = "SHEKHER NAGAR",
SIRAJDIKHAN = "SIRAJDIKHAN",
BAGHRA = "BAGHRA",
BARIKHAL = "BARIKHAL",
BHAGGYAKUL = "BHAGGYAKUL",
HASHARA = "HASHARA",
KOLAPARA = "KOLAPARA",
KUMARBHOG = "KUMARBHOG",
MAZPARA = "MAZPARA",
SRINAGAR = "SRINAGAR",
VAGGYAKUL SO = "VAGGYAKUL SO",
BAJRAJUGINI = "BAJRAJUGINI",
BALIGAO = "BALIGAO",
BETKAHAT = "BETKAHAT",
DIGHIRPAR = "DIGHIRPAR",
HASAIL = "HASAIL",
PURA = "PURA",
PURA EDSO = "PURA EDSO",
TANGIBARI = "TANGIBARI",
BHALUKA = "BHALUKA",
FULBARIA = "FULBARIA",
DUTTARBAZAR = "DUTTARBAZAR",
GAFORGAON = "GAFORGAON",
KANDIPARA = "KANDIPARA",
SHIBGANJ = "SHIBGANJ",
USTI = "USTI",
GOURIPUR = "GOURIPUR",
RAMGOPALPUR = "RAMGOPALPUR",
DHARA = "DHARA",
HALUAGHAT = "HALUAGHAT",
MUNSHIRHAT = "MUNSHIRHAT",
ATHARABARI = "ATHARABARI",
ISSHWARGONJ = "ISSHWARGONJ",
SOHAGI = "SOHAGI",
MUKTAGACHHA = "MUKTAGACHHA",
AGRICULTURE UNIVERSI = "AGRICULTURE UNIVERSI",
BIDDYAGANJ = "BIDDYAGANJ",
KAWATKHALI = "KAWATKHALI",
MYMENSINGH SADAR = "MYMENSINGH SADAR",
PEARPUR = "PEARPUR",
SHOMBHUGANJ = "SHOMBHUGANJ",
GANGAIL = "GANGAIL",
NANDAIL = "NANDAIL",
BELTIA = "BELTIA",
PHULPUR = "PHULPUR",
TARAKANDA = "TARAKANDA",
AHMADBAD = "AHMADBAD",
DHALA = "DHALA",
RAM AMRITAGANJ = "RAM AMRITAGANJ",
TRISHAL = "TRISHAL",
ARAIHAZAR = "ARAIHAZAR",
GOPALDI = "GOPALDI",
BAIDDER BAZAR = "BAIDDER BAZAR",
BARA NAGAR = "BARA NAGAR",
BARODI = "BARODI",
BANDAR = "BANDAR",
BIDS = "BIDS",
D.C MILLS = "D.C MILLS",
MADANGANJ = "MADANGANJ",
NABIGANJ = "NABIGANJ",
FATULLA BAZAR = "FATULLA BAZAR",
FATULLAH = "FATULLAH",
NARAYANGANJ SADAR = "NARAYANGANJ SADAR",
BHULTA = "BHULTA",
KANCHAN = "KANCHAN",
MURAPARA = "MURAPARA",
NAGRI = "NAGRI",
RUPGANJ = "RUPGANJ",
ADAMJEENAGAR = "ADAMJEENAGAR",
LN MILLS = "LN MILLS",
SIDDIRGANJ = "SIDDIRGANJ",
BELABO = "BELABO",
HATIRDIA = "HATIRDIA",
KATABARIA = "KATABARIA",
MONOHORDI = "MONOHORDI",
KARIMPUR = "KARIMPUR",
MADHABDI = "MADHABDI",
NARSHINGDI COLLEGE = "NARSHINGDI COLLEGE",
NARSHINGDI SADAR = "NARSHINGDI SADAR",
PANCHDONA = "PANCHDONA",
UMC JUTE MILLS = "UMC JUTE MILLS",
CHAR SINDHUR = "CHAR SINDHUR",
GHORASHAL = "GHORASHAL",
GHORASHAL UREA FACTO = "GHORASHAL UREA FACTO",
PALASH = "PALASH",
BAZAR HASNABAD = "BAZAR HASNABAD",
RADHAGANJ BAZAR = "RADHAGANJ BAZAR",
RAYPURA = "RAYPURA",
SHIBPUR = "SHIBPUR",
SUSNNG DURGAPUR = "SUSNNG DURGAPUR",
ATPARA = "ATPARA",
BARHATTA = "BARHATTA",
DHARAMPASHA = "DHARAMPASHA",
DHOBAURA = "DHOBAURA",
SAKOAI = "SAKOAI",
KALMAKANDA = "KALMAKANDA",
KENDUA = "KENDUA",
KHALIAJHRI = "KHALIAJHRI",
SHALDIGHA = "SHALDIGHA",
MADAN = "MADAN",
MODDOYNAGAR = "MODDOYNAGAR",
MOHANGANJ = "MOHANGANJ",
BAIKHERHATI = "BAIKHERHATI",
NETRAKONA SADAR = "NETRAKONA SADAR",
JARIA JHANJHAIL = "JARIA JHANJHAIL",
PURBADHOLA = "PURBADHOLA",
SHAMGONJ = "SHAMGONJ",
BALIAKANDI = "BALIAKANDI",
NALIA = "NALIA",
MRIGIBAZAR = "MRIGIBAZAR",
PANGSHA = "PANGSHA",
RAMKOL = "RAMKOL",
RATANDIA = "RATANDIA",
GOALANDA = "GOALANDA",
KHANKHANAPUR = "KHANKHANAPUR",
RAJBARI SADAR = "RAJBARI SADAR",
BHEDORGANJ = "BHEDORGANJ",
DAMUDHYA = "DAMUDHYA",
GOSAIRHAT = "GOSAIRHAT",
JAJIRA = "JAJIRA",
BHOZESHWAR = "BHOZESHWAR",
GHARISAR = "GHARISAR",
KARTIKPUR = "KARTIKPUR",
NARIA = "NARIA",
UPSHI = "UPSHI",
ANGARIA = "ANGARIA",
CHIKANDI = "CHIKANDI",
SHARIATPUR SADAR = "SHARIATPUR SADAR",
BAKSHIGONJ = "BAKSHIGONJ",
JHINAIGATI = "JHINAIGATI",
GONOPADDI = "GONOPADDI",
NAKLA = "NAKLA",
HATIBANDHA = "HATIBANDHA",
NALITABARI = "NALITABARI",
SHERPUR SHADAR = "SHERPUR SHADAR",
SHRIBARDI = "SHRIBARDI",
BASAIL = "BASAIL",
BHUAPUR = "BHUAPUR",
DELDUAR = "DELDUAR",
ELASIN = "ELASIN",
HINGA NAGAR = "HINGA NAGAR",
JANGALIA = "JANGALIA",
LOWHATI = "LOWHATI",
PATHARAIL = "PATHARAIL",
D. PAKUTIA = "D. PAKUTIA",
DHALAPARA = "DHALAPARA",
GHATIAL = "GHATIAL",
LOHANI = "LOHANI",
ZAHIDGANJ = "ZAHIDGANJ",
GOPALPUR = "GOPALPUR",
HEMNAGAR = "HEMNAGAR",
JHOWAIL = "JHOWAIL",
BALLABAZAR = "BALLABAZAR",
ELINGA = "ELINGA",
KALIHATI = "KALIHATI",
NAGARBARI = "NAGARBARI",
NAGARBARI SO = "NAGARBARI SO",
NAGBARI = "NAGBARI",
PALISHA = "PALISHA",
RAJAFAIR = "RAJAFAIR",
KASHKAWLIA = "KASHKAWLIA",
DHOBARI = "DHOBARI",
MADHUPUR = "MADHUPUR",
GORAI = "GORAI",
JARMUKI = "JARMUKI",
M.C. COLLEGE = "M.C. COLLEGE",
MIRZAPUR = "MIRZAPUR",
MOHERA = "MOHERA",
WARRI PAIKPARA = "WARRI PAIKPARA",
DHUBURIA = "DHUBURIA",
NAGARPUR = "NAGARPUR",
SALIMABAD = "SALIMABAD",
KOCHUA = "KOCHUA",
SAKHIPUR = "SAKHIPUR",
KAGMARI = "KAGMARI",
KOROTIA = "KOROTIA",
PURABARI = "PURABARI",
SANTOSH = "SANTOSH",
TANGAIL SADAR = "TANGAIL SADAR",
BAGERHAT SADAR = "BAGERHAT SADAR",
P.C COLLEGE = "P.C COLLEGE",
RANGDIA = "RANGDIA",
CHALNA ANKORAGE = "CHALNA ANKORAGE",
MONGLA PORT = "MONGLA PORT",
BARABARIA = "BARABARIA",
CHITALMARI = "CHITALMARI",
BHANGANPAR BAZAR = "BHANGANPAR BAZAR",
FAKIRHAT = "FAKIRHAT",
MANSA = "MANSA",
KACHUA = "KACHUA",
SONARKOLA = "SONARKOLA",
CHARKULIA = "CHARKULIA",
DARIALA = "DARIALA",
KAHALPUR = "KAHALPUR",
MOLLAHAT = "MOLLAHAT",
NAGARKANDI = "NAGARKANDI",
PAK GANGNI = "PAK GANGNI",
MORELGANJ = "MORELGANJ",
SANNASI BAZAR = "SANNASI BAZAR",
TELISATEE = "TELISATEE",
FOYLAHAT = "FOYLAHAT",
GOURAMBHA = "GOURAMBHA",
RAMPAL = "RAMPAL",
SONATUNIA = "SONATUNIA",
RAYENDA = "RAYENDA",
ALAMDANGA = "ALAMDANGA",
HARDI = "HARDI",
CHUADANGA SADAR = "CHUADANGA SADAR",
MUNSHIGANJ = "MUNSHIGANJ",
ANDULBARIA = "ANDULBARIA",
DAMURHUDA = "DAMURHUDA",
DARSHANA = "DARSHANA",
DOULATGANJ = "DOULATGANJ",
BAGHARPARA = "BAGHARPARA",
GOURANAGAR = "GOURANAGAR",
CHOUGACHHA = "CHOUGACHHA",
BASUNDIA = "BASUNDIA",
CHANCHRA = "CHANCHRA",
CHURAMANKATHI = "CHURAMANKATHI",
JESSORE AIRBACH = "JESSORE AIRBACH",
JESSORE CANTTONMENT = "JESSORE CANTTONMENT",
JESSORE SADAR = "JESSORE SADAR",
JESSORE UPA-SHAHAR = "JESSORE UPA-SHAHAR",
RUPDIA = "RUPDIA",
JHIKARGACHHA = "JHIKARGACHHA",
KESHOBPUR = "KESHOBPUR",
MONIRAMPUR = "MONIRAMPUR",
BHUGILHAT = "BHUGILHAT",
NOAPARA = "NOAPARA",
RAJGHAT = "RAJGHAT",
BAG ACHRA = "BAG ACHRA",
BENAPOLE = "BENAPOLE",
JADABPUR = "JADABPUR",
SARSA = "SARSA",
HARINAKUNDU = "HARINAKUNDU",
JINAIDAHA CADET COLLEGE = "JINAIDAHA CADET COLLEGE",
JINAIDAHA SADAR = "JINAIDAHA SADAR",
KOTCHANDPUR = "KOTCHANDPUR",
MAHESHPUR = "MAHESHPUR",
HATBAR BAZAR = "HATBAR BAZAR",
NALDANGA = "NALDANGA",
KUMIRADAHA = "KUMIRADAHA",
SHAILAKUPA = "SHAILAKUPA",
ALAIPUR = "ALAIPUR",
BELPHULIA = "BELPHULIA",
RUPSHA = "RUPSHA",
BATIAGHAT = "BATIAGHAT",
SURKALEE = "SURKALEE",
BAJUA = "BAJUA",
CHALNA BAZAR = "CHALNA BAZAR",
DAKUP = "DAKUP",
NALIAN = "NALIAN",
CHANDNI MAHAL = "CHANDNI MAHAL",
DIGALIA = "DIGALIA",
GAZIRHAT = "GAZIRHAT",
GHOSHGHATI = "GHOSHGHATI",
SENHATI = "SENHATI",
ATRA SHILPA AREA = "ATRA SHILPA AREA",
BIT KHULNA = "BIT KHULNA",
DOULATPUR = "DOULATPUR",
JAHANABAD CANTTONMEN = "JAHANABAD CANTTONMEN",
KHULA SADAR = "KHULA SADAR",
KHULNA G.P.O = "KHULNA G.P.O",
KHULNA SHIPYARD = "KHULNA SHIPYARD",
KHULNA UNIVERSITY = "KHULNA UNIVERSITY",
SIRAMANI = "SIRAMANI",
SONALI JUTE MILLS = "SONALI JUTE MILLS",
AMADEE = "AMADEE",
MADINABAD = "MADINABAD",
CHANDKHALI = "CHANDKHALI",
GARAIKHALI = "GARAIKHALI",
GODAIPUR = "GODAIPUR",
KAPILMONI = "KAPILMONI",
KATIPARA = "KATIPARA",
PAIKGACHHA = "PAIKGACHHA",
PHULTALA = "PHULTALA",
CHUKNAGAR = "CHUKNAGAR",
GHONABANDA = "GHONABANDA",
SAJIARA = "SAJIARA",
SHAHAPUR = "SHAHAPUR",
PAK BARASAT = "PAK BARASAT",
TERAKHADA = "TERAKHADA",
ALLARDARGA = "ALLARDARGA",
BHERAMARA = "BHERAMARA",
GANGES BHERAMARA = "GANGES BHERAMARA",
JANIPUR = "JANIPUR",
KHOKSA = "KHOKSA",
KUMARKHALI = "KUMARKHALI",
PANTI = "PANTI",
ISLAMI UNIVERSITY = "ISLAMI UNIVERSITY",
JAGATI = "JAGATI",
KUSHTIA MOHINI = "KUSHTIA MOHINI",
KUSTIA SADAR = "KUSTIA SADAR",
AMLA SADARPUR = "AMLA SADARPUR",
MIRPUR = "MIRPUR",
PORADAHA = "PORADAHA",
KHASMATHURAPUR = "KHASMATHURAPUR",
RAFAYETPUR = "RAFAYETPUR",
TARAGUNIA = "TARAGUNIA",
ARPARA = "ARPARA",
MAGURA SADAR = "MAGURA SADAR",
BINODPUR = "BINODPUR",
MOHAMMADPUR = "MOHAMMADPUR",
NAHATA = "NAHATA",
LANGALBADH = "LANGALBADH",
NACHOL = "NACHOL",
SHRIPUR = "SHRIPUR",
GANGNI = "GANGNI",
AMJHUPI = "AMJHUPI",
AMJHUPI = "AMJHUPI",
MEHERPUR SADAR = "MEHERPUR SADAR",
MUJIB NAGAR COMPLEX = "MUJIB NAGAR COMPLEX",
KALIA = "KALIA",
BARADIA = "BARADIA",
ITNA = "ITNA",
LAXMIPASHA = "LAXMIPASHA",
LOHAGORA = "LOHAGORA",
NALDI = "NALDI",
MOHAJAN = "MOHAJAN",
NARAIL SADAR = "NARAIL SADAR",
RATANGANJ = "RATANGANJ",
ASHASHUNI = "ASHASHUNI",
BARADAL = "BARADAL",
DEBBHATA = "DEBBHATA",
GURUGRAM = "GURUGRAM",
CHANDANPUR = "CHANDANPUR",
HAMIDPUR = "HAMIDPUR",
JHAUDANGA = "JHAUDANGA",
KALAROA = "KALAROA",
KHORDO = "KHORDO",
MURARIKATI = "MURARIKATI",
KALIGANJ UPO = "KALIGANJ UPO",
NALTA MUBAROKNAGAR = "NALTA MUBAROKNAGAR",
RATANPUR = "RATANPUR",
BURI GOALINI = "BURI GOALINI",
GABURA = "GABURA",
HABINAGAR = "HABINAGAR",
NAKIPUR = "NAKIPUR",
NAOBEKI = "NAOBEKI",
NOORNAGAR = "NOORNAGAR",
BUDHHAT = "BUDHHAT",
GUNAKAR KATI = "GUNAKAR KATI",
SATKHIRA ISLAMIA ACC = "SATKHIRA ISLAMIA ACC",
SATKHIRA SADAR = "SATKHIRA SADAR",
PATKELGHATA = "PATKELGHATA",
TAALA = "TAALA",
ADAMDIGHI = "ADAMDIGHI",
NASHARATPUR = "NASHARATPUR",
SANTAHAR = "SANTAHAR",
BOGRA CANTTONMENT = "BOGRA CANTTONMENT",
BOGRA SADAR = "BOGRA SADAR",
DHUNAT = "DHUNAT",
GOSAIBARI = "GOSAIBARI",
DUPCHACHIA = "DUPCHACHIA",
TALORA = "TALORA",
GABTOLI = "GABTOLI",
SUKHANPUKUR = "SUKHANPUKUR",
KAHALU = "KAHALU",
NANDIGRAM = "NANDIGRAM",
CHANDAN BAISHA = "CHANDAN BAISHA",
SARIAKANDI = "SARIAKANDI",
CHANDAIKONA = "CHANDAIKONA",
PALLI UNNYAN ACCADEM = "PALLI UNNYAN ACCADEM",
SHERPUR = "SHERPUR",
SHIBGANJ = "SHIBGANJ",
SONATOLA = "SONATOLA",
BHOLAHAT = "BHOLAHAT",
AMNURA = "AMNURA",
CHAPINAWBGANJ SADAR = "CHAPINAWBGANJ SADAR",
RAJARAMPUR = "RAJARAMPUR",
RAMCHANDRAPUR = "RAMCHANDRAPUR",
MANDUMALA = "MANDUMALA",
NACHOL = "NACHOL",
GOMASHTAPUR = "GOMASHTAPUR",
ROHANPUR = "ROHANPUR",
KANSART = "KANSART",
MANAKSHA = "MANAKSHA",
SHIBGANJ U.P.O = "SHIBGANJ U.P.O",
AKKLEPUR = "AKKLEPUR",
JAMALGANJ = "JAMALGANJ",
TILAKPUR = "TILAKPUR",
JOYPURHAT SADAR = "JOYPURHAT SADAR",
KALAI = "KALAI",
KHETLAL = "KHETLAL",
PANCHBIBI = "PANCHBIBI",
AHSANGANJ = "AHSANGANJ",
BANDAI = "BANDAI",
BADALGACHHI = "BADALGACHHI",
DHAMUIRHAT = "DHAMUIRHAT",
MAHADEBPUR = "MAHADEBPUR",
NAOGAON SADAR = "NAOGAON SADAR",
NIAMATPUR = "NIAMATPUR",
NITPUR = "NITPUR",
PANGURIA = "PANGURIA",
PORSA = "PORSA",
PATNITALA = "PATNITALA",
BALIHAR = "BALIHAR",
MANDA = "MANDA",
PRASADPUR = "PRASADPUR",
KASHIMPUR = "KASHIMPUR",
RANINAGAR = "RANINAGAR",
MODUHIL = "MODUHIL",
SAPAHAR = "SAPAHAR",
ABDULPUR = "ABDULPUR",
GOPALPUR U.P.O = "GOPALPUR U.P.O",
LALPUR S.O = "LALPUR S.O",
BARAIGRAM = "BARAIGRAM",
DAYARAMPUR = "DAYARAMPUR",
HARUA = "HARUA",
HATGURUDASPUR = "HATGURUDASPUR",
LAXMAN = "LAXMAN",
BAIDDYABAL GHARIA = "BAIDDYABAL GHARIA",
DIGAPATIA = "DIGAPATIA",
MADHNAGAR = "MADHNAGAR",
NATORE SADAR = "NATORE SADAR",
SINGRA = "SINGRA",
BANWARINAGAR = "BANWARINAGAR",
BERA = "BERA",
KASHINATHPUR = "KASHINATHPUR",
NAKALIA = "NAKALIA",
PURAN BHARENGA = "PURAN BHARENGA",
BHANGURA = "BHANGURA",
CHATMOHAR = "CHATMOHAR",
DEBOTTAR = "DEBOTTAR",
DHAPARI = "DHAPARI",
ISHWARDI = "ISHWARDI",
PAKSHI = "PAKSHI",
RAJAPUR = "RAJAPUR",
HAMAYETPUR = "HAMAYETPUR",
KALIKO COTTON MILLS = "KALIKO COTTON MILLS",
PABNA SADAR = "PABNA SADAR",
SATHIA = "SATHIA",
SAGARKANDI = "SAGARKANDI",
SUJANAGAR = "SUJANAGAR",
ARANI = "ARANI",
BAGHA = "BAGHA",
BHABANIGANJ = "BHABANIGANJ",
TAHARPUR = "TAHARPUR",
CHARGHAT = "CHARGHAT",
SARDA = "SARDA",
DURGAPUR = "DURGAPUR",
GODAGARI = "GODAGARI",
PREMTOLI = "PREMTOLI",
KHODMOHANPUR = "KHODMOHANPUR",
LALITGANJ = "LALITGANJ",
RAJSHAHI SUGAR MILLS = "RAJSHAHI SUGAR MILLS",
SHYAMPUR = "SHYAMPUR",
PUTIA = "PUTIA",
BINODPUR BAZAR = "BINODPUR BAZAR",
GHURAMARA = "GHURAMARA",
KAZLA = "KAZLA",
RAJSHAHI CANTTONMENT = "RAJSHAHI CANTTONMENT",
RAJSHAHI COURT = "RAJSHAHI COURT",
RAJSHAHI SADAR = "RAJSHAHI SADAR",
RAJSHAHI UNIVERSITY = "RAJSHAHI UNIVERSITY",
SAPURA = "SAPURA",
TANOR = "TANOR",
BAIDDYA JAM TOIL = "BAIDDYA JAM TOIL",
BELKUCHI = "BELKUCHI",
ENAYETPUR = "ENAYETPUR",
RAJAPUR = "RAJAPUR",
SOHAGPUR = "SOHAGPUR",
STHAL = "STHAL",
DHANGORA = "DHANGORA",
MALONGA = "MALONGA",
GANDAIL = "GANDAIL",
KAZIPUR = "KAZIPUR",
SHUVGACHHA = "SHUVGACHHA",
JAMIRTA = "JAMIRTA",
KAIJURI = "KAIJURI",
PORJANA = "PORJANA",
SHAHJADPUR = "SHAHJADPUR",
RAIPUR = "RAIPUR",
RASHIDABAD = "RASHIDABAD",
SIRAJGANJ SADAR = "SIRAJGANJ SADAR",
TARASH = "TARASH",
LAHIRI MOHANPUR = "LAHIRI MOHANPUR",
SALAP = "SALAP",
ULLAPARA = "ULLAPARA",
ULLAPARA R.S = "ULLAPARA R.S",
BANGLA HILI = "BANGLA HILI",
BIRAL = "BIRAL",
BIRAMPUR = "BIRAMPUR",
BIRGANJ = "BIRGANJ",
CHRIRBANDAR = "CHRIRBANDAR",
RANIRBANDAR = "RANIRBANDAR",
DINAJPUR RAJBARI = "DINAJPUR RAJBARI",
DINAJPUR SADAR = "DINAJPUR SADAR",
KHANSAMA = "KHANSAMA",
PAKARHAT = "PAKARHAT",
MAHARAJGANJ = "MAHARAJGANJ",
DAUDPUR = "DAUDPUR",
GOPALPUR = "GOPALPUR",
NABABGANJ = "NABABGANJ",
GHORAGHAT = "GHORAGHAT",
OSMANPUR = "OSMANPUR",
PARBATIPUR = "PARBATIPUR",
PHULBARI = "PHULBARI",
SETABGANJ = "SETABGANJ",
BONARPARA = "BONARPARA",
SAGHATA = "SAGHATA",
GAIBANDHA SADAR = "GAIBANDHA SADAR",
GOBINDHAGANJ = "GOBINDHAGANJ",
MAHIMAGANJ = "MAHIMAGANJ",
PALASHBARI = "PALASHBARI",
BHARATKHALI = "BHARATKHALI",
PHULCHHARI = "PHULCHHARI",
NALDANGA = "NALDANGA",
SAADULLAPUR = "SAADULLAPUR",
BAMANDANGA = "BAMANDANGA",
SUNDARGANJ = "SUNDARGANJ",
BHURUNGAMARI = "BHURUNGAMARI",
CHILMARI = "CHILMARI",
JORGACHH = "JORGACHH",
KURIGRAM SADAR = "KURIGRAM SADAR",
PANDUL = "PANDUL",
PHULBARI = "PHULBARI",
NAGESHWAR = "NAGESHWAR",
NAZIMKHAN = "NAZIMKHAN",
RAJARHAT = "RAJARHAT",
RAJIBPUR = "RAJIBPUR",
ROUMARI = "ROUMARI",
BAZARHAT = "BAZARHAT",
ULIPUR = "ULIPUR",
ADITMARI = "ADITMARI",
HATIBANDHA = "HATIBANDHA",
KULAGHAT SO = "KULAGHAT SO",
LALMONIRHAT SADAR = "LALMONIRHAT SADAR",
MOGHALHAT = "MOGHALHAT",
BAURA = "BAURA",
BURIMARI = "BURIMARI",
PATGRAM = "PATGRAM",
TUSHBHANDAR = "TUSHBHANDAR",
DIMLA = "DIMLA",
GHAGA KHARIBARI = "GHAGA KHARIBARI",
CHILAHATI = "CHILAHATI",
DOMAR = "DOMAR",
JALDHAKA = "JALDHAKA",
KISHORIGANJ = "KISHORIGANJ",
NILPHAMARI SADAR = "NILPHAMARI SADAR",
NILPHAMARI SUGAR MIL = "NILPHAMARI SUGAR MIL",
SYEDPUR = "SYEDPUR",
SYEDPUR UPASHAHAR = "SYEDPUR UPASHAHAR",
BODA = "BODA",
CHOTTO DAB = "CHOTTO DAB",
MIRJAPUR = "MIRJAPUR",
DABIGANJ = "DABIGANJ",
PANCHAGARH SADAR = "PANCHAGARH SADAR",
TETULIA = "TETULIA",
BADARGANJ = "BADARGANJ",
SHYAMPUR = "SHYAMPUR",
GANGACHARA = "GANGACHARA",
HARAGACHH = "HARAGACHH",
KAUNIA = "KAUNIA",
MITHAPUKUR = "MITHAPUKUR",
PIRGACHHA = "PIRGACHHA",
ALAMNAGAR = "ALAMNAGAR",
MAHIGANJ = "MAHIGANJ",
RANGPUR CADET COLLEG = "RANGPUR CADET COLLEG",
RANGPUR CARMIECAL COL = "RANGPUR CARMIECAL COL",
RANGPUR SADAR = "RANGPUR SADAR",
RANGPUR UPA-SHAHAR = "RANGPUR UPA-SHAHAR",
TARAGANJ = "TARAGANJ",
BALIADANGI = "BALIADANGI",
LAHIRI = "LAHIRI",
JIBANPUR = "JIBANPUR",
PIRGANJ = "PIRGANJ",
PIRGANJ = "PIRGANJ",
NEKMARAD = "NEKMARAD",
RANI SANKAIL = "RANI SANKAIL",
RUHIA = "RUHIA",
SHIBGANJ = "SHIBGANJ",
THAKURGAON ROAD = "THAKURGAON ROAD",
THAKURGAON SADAR = "THAKURGAON SADAR",
AZMIREEGANJ = "AZMIREEGANJ",
BAHUBAL = "BAHUBAL",
BANIACHANG = "BANIACHANG",
JATRAPASHA = "JATRAPASHA",
KADIRGANJ = "KADIRGANJ",
CHANDPURBAGAN = "CHANDPURBAGAN",
CHUNARUGHAT = "CHUNARUGHAT",
NARAPATI = "NARAPATI",
GOPAYA = "GOPAYA",
HOBIGANJ SADAR = "HOBIGANJ SADAR",
SHAESTAGANJ = "SHAESTAGANJ",
KALAUK = "KALAUK",
LAKHAI = "LAKHAI",
ITAKHOLA = "ITAKHOLA",
MADHABPUR = "MADHABPUR",
SAIHAMNAGAR = "SAIHAMNAGAR",
SHAHAJIBAZAR = "SHAHAJIBAZAR",
DIGALBAK = "DIGALBAK",
GOLDUBA = "GOLDUBA",
GOPLARBAZAR = "GOPLARBAZAR",
INATHGANJ = "INATHGANJ",
NABIGANJ = "NABIGANJ",
BARALEKHA = "BARALEKHA",
DHAKKHINBAG = "DHAKKHINBAG",
JURI = "JURI",
PURBASHAHABAJPUR = "PURBASHAHABAJPUR",
KAMALGANJ = "KAMALGANJ",
KERAMATNAGA = "KERAMATNAGA",
MUNSHIBAZAR = "MUNSHIBAZAR",
PATRAKHOLA = "PATRAKHOLA",
SHAMSHER NAGAR = "SHAMSHER NAGAR",
BARAMCHAL = "BARAMCHAL",
KAJALDHARA = "KAJALDHARA",
KARIMPUR = "KARIMPUR",
KULAURA = "KULAURA",
LANGLA = "LANGLA",
PRITHIMPASHA = "PRITHIMPASHA",
TILLAGAON = "TILLAGAON",
AFROZGANJ = "AFROZGANJ",
BARAKAPAN = "BARAKAPAN",
MONUMUKH = "MONUMUKH",
MOULVIBAZAR SADAR = "MOULVIBAZAR SADAR",
RAJNAGAR = "RAJNAGAR",
KALIGHAT = "KALIGHAT",
KHEJURICHHARA = "KHEJURICHHARA",
NARAIN CHORA = "NARAIN CHORA",
SATGAON = "SATGAON",
SRIMANGAL = "SRIMANGAL",
BISHAMSAPUR = "BISHAMSAPUR",
CHHATAK = "CHHATAK",
CHHATAK CEMENT FACTO = "CHHATAK CEMENT FACTO",
CHHATAK PAPER MILLS = "CHHATAK PAPER MILLS",
CHOURANGI BAZAR = "CHOURANGI BAZAR",
GABINDAGANJ = "GABINDAGANJ",
GABINDAGANJ NATUN BA = "GABINDAGANJ NATUN BA",
ISLAMABAD = "ISLAMABAD",
JAHIDPUR = "JAHIDPUR",
KHURMA = "KHURMA",
MOINPUR = "MOINPUR",
DHIRAI CHANDPUR = "DHIRAI CHANDPUR",
JAGDAL = "JAGDAL",
DUARA BAZAR = "DUARA BAZAR",
GHUNGIAR = "GHUNGIAR",
ATUAJAN = "ATUAJAN",
HASAN FATEMAPUR = "HASAN FATEMAPUR",
JAGNNATHPUR = "JAGNNATHPUR",
RASULGANJ = "RASULGANJ",
SHIRAMSI = "SHIRAMSI",
SYEDPUR = "SYEDPUR",
SACHNA = "SACHNA",
PAGLA = "PAGLA",
PATHARIA = "PATHARIA",
SUNAMGANJ SADAR = "SUNAMGANJ SADAR",
TAHIRPUR = "TAHIRPUR",
BALAGANJ = "BALAGANJ",
BEGUMPUR = "BEGUMPUR",
BRAHMAN SHASHON = "BRAHMAN SHASHON",
GAHARPUR = "GAHARPUR",
GOALA BAZAR = "GOALA BAZAR",
KARUA = "KARUA",
KATHAL KHAIR = "KATHAL KHAIR",
NATUN BAZAR = "NATUN BAZAR",
OMARPUR = "OMARPUR",
TAJPUR = "TAJPUR",
BIANIBAZAR = "BIANIBAZAR",
CHURKAI = "CHURKAI",
JALDUP = "JALDUP",
KURAR BAZAR = "KURAR BAZAR",
MATHIURA = "MATHIURA",
SALIA BAZAR = "SALIA BAZAR",
BISHWANATH = "BISHWANATH",
DASHGHAR = "DASHGHAR",
DEOKALAS = "DEOKALAS",
DOULATHPUR = "DOULATHPUR",
SINGER KANCH = "SINGER KANCH",
FENCHUGANJ = "FENCHUGANJ",
FENCHUGANJ SAREKARKH = "FENCHUGANJ SAREKARKH",
CHIKNAGUL = "CHIKNAGUL",
GOAINHAT = "GOAINHAT",
JAFLONG = "JAFLONG",
BANIGRAM = "BANIGRAM",
CHANDANPUR = "CHANDANPUR",
DAKKHIN BHADASHORE = "DAKKHIN BHADASHORE",
DHAKA DAKKHIN = "DHAKA DAKKHIN",
GOPALGANNJ = "GOPALGANNJ",
RANAPING = "RANAPING",
JAINTHAPUR = "JAINTHAPUR",
ICHHAMATI = "ICHHAMATI",
JAKIGANJ = "JAKIGANJ",
CHATULBAZAR = "CHATULBAZAR",
GACHBARI = "GACHBARI",
KANAIGHAT = "KANAIGHAT",
MANIKGANJ = "MANIKGANJ",
KOMPANYGANJ = "KOMPANYGANJ",
BIRAHIMPUR = "BIRAHIMPUR",
JALALABAD = "JALALABAD",
JALALABAD CANTOMENT = "JALALABAD CANTOMENT",
KADAMTALI = "KADAMTALI",
KAMALBAZER = "KAMALBAZER",
KHADIMNAGAR = "KHADIMNAGAR",
LALBAZAR = "LALBAZAR",
MOGLA = "MOGLA",
RANGA HAJIGANJ = "RANGA HAJIGANJ",
SHAHAJALAL SCIENCE & = "SHAHAJALAL SCIENCE &",
SILAM = "SILAM",
SYLHE SADAR = "SYLHE SADAR",
SYLHET BIMAN BONDAR = "SYLHET BIMAN BONDAR",
SYLHET CADET COL = "SYLHET CADET COL",
