AMTALI = "AMTALI",
BAMNA = "BAMNA",
BARGUNA SADAR = "BARGUNA SADAR",
BETAGI = "BETAGI",
PATHARGHATA = "PATHARGHATA",
TALTALI = "TALTALI",
MULADI = "MULADI",
BABUGANJ = "BABUGANJ",
AGAILJHARA = "AGAILJHARA",
BARISAL SADAR = "BARISAL SADAR",
BAKERGANJ = "BAKERGANJ",
BANARIPARA = "BANARIPARA",
GAURNADI = "GAURNADI",
HIZLA = "HIZLA",
MEHENDIGANJ = "MEHENDIGANJ",
WAZIRPUR = "WAZIRPUR",
BHOLA SADAR = "BHOLA SADAR",
BURHANUDDIN = "BURHANUDDIN",
CHAR FASSON = "CHAR FASSON",
DAULATKHAN = "DAULATKHAN",
LALMOHAN = "LALMOHAN",
MANPURA = "MANPURA",
TAZUMUDDIN = "TAZUMUDDIN",
JHALOKATI SADAR = "JHALOKATI SADAR",
KATHALIA = "KATHALIA",
NALCHITY = "NALCHITY",
RAJAPUR = "RAJAPUR",
BAUPHAL = "BAUPHAL",
DASHMINA = "DASHMINA",
GALACHIPA = "GALACHIPA",
KALAPARA = "KALAPARA",
MIRZAGANJ = "MIRZAGANJ",
PATUAKHALI SADAR = "PATUAKHALI SADAR",
DUMKI = "DUMKI",
RANGABALI = "RANGABALI",
BHANDARIA = "BHANDARIA",
KAUKHALI = "KAUKHALI",
MATHBARIA = "MATHBARIA",
NAZIRPUR = "NAZIRPUR",
NESARABAD = "NESARABAD",
PIROJPUR SADAR = "PIROJPUR SADAR",
ZIANAGAR = "ZIANAGAR",
BANDARBAN SADAR = "BANDARBAN SADAR",
THANCHI = "THANCHI",
LAMA = "LAMA",
NAIKHONGCHHARI = "NAIKHONGCHHARI",
ALI KADAM = "ALI KADAM",
ROWANGCHHARI = "ROWANGCHHARI",
RUMA = "RUMA",
BRAHMANBARIA SADAR = "BRAHMANBARIA SADAR",
ASHUGANJ = "ASHUGANJ",
NASIRNAGAR = "NASIRNAGAR",
NABINAGAR = "NABINAGAR",
SARAIL = "SARAIL",
SHAHBAZPUR TOWN = "SHAHBAZPUR TOWN",
KASBA = "KASBA",
AKHAURA = "AKHAURA",
BANCHARAMPUR = "BANCHARAMPUR",
BIJOYNAGAR = "BIJOYNAGAR",
CHANDPUR SADAR = "CHANDPUR SADAR",
FARIDGANJ = "FARIDGANJ",
HAIMCHAR = "HAIMCHAR",
HAZIGANJ = "HAZIGANJ",
KACHUA = "KACHUA",
MATLAB UTTAR = "MATLAB UTTAR",
MATLAB DAKKHIN = "MATLAB DAKKHIN",
SHAHRASTI = "SHAHRASTI",
ANWARA = "ANWARA",
BANSHKHALI = "BANSHKHALI",
BOALKHALI = "BOALKHALI",
CHANDANAISH = "CHANDANAISH",
FATIKCHHARI = "FATIKCHHARI",
HATHAZARI = "HATHAZARI",
LOHAGARA = "LOHAGARA",
MIRSHARAI = "MIRSHARAI",
PATIYA = "PATIYA",
RANGUNIA = "RANGUNIA",
RAOZAN = "RAOZAN",
SANDWIP = "SANDWIP",
SATKANIA = "SATKANIA",
SITAKUNDA = "SITAKUNDA",
BARURA = "BARURA",
BRAHMANPARA = "BRAHMANPARA",
BURICHONG = "BURICHONG",
CHANDINA = "CHANDINA",
CHAUDDAGRAM = "CHAUDDAGRAM",
DAUDKANDI = "DAUDKANDI",
DEBIDWAR = "DEBIDWAR",
HOMNA = "HOMNA",
COMILLA SADAR = "COMILLA SADAR",
LAKSAM = "LAKSAM",
MONOHORGONJ = "MONOHORGONJ",
MEGHNA = "MEGHNA",
MURADNAGAR = "MURADNAGAR",
NANGALKOT = "NANGALKOT",
COMILLA SADAR SOUTH = "COMILLA SADAR SOUTH",
TITAS = "TITAS",
CHAKARIA = "CHAKARIA",
{{198}}''{{199}} = "{{198}}''{{199}}",
KUTUBDIA = "KUTUBDIA",
MAHESHKHALI = "MAHESHKHALI",
RAMU = "RAMU",
TEKNAF = "TEKNAF",
UKHIA = "UKHIA",
PEKUA = "PEKUA",
FENI SADAR = "FENI SADAR",
CHAGALNAIYA = "CHAGALNAIYA",
DAGANBHYAN = "DAGANBHYAN",
PARSHURAM = "PARSHURAM",
FHULGAZI = "FHULGAZI",
SONAGAZI = "SONAGAZI",
DIGHINALA = "DIGHINALA",
KHAGRACHHARI = "KHAGRACHHARI",
LAKSHMICHHARI = "LAKSHMICHHARI",
MAHALCHHARI = "MAHALCHHARI",
MANIKCHHARI = "MANIKCHHARI",
MATIRANGA = "MATIRANGA",
PANCHHARI = "PANCHHARI",
RAMGARH = "RAMGARH",
LAKSHMIPUR SADAR = "LAKSHMIPUR SADAR",
RAIPUR = "RAIPUR",
RAMGANJ = "RAMGANJ",
RAMGATI = "RAMGATI",
KOMOL NAGAR = "KOMOL NAGAR",
NOAKHALI SADAR = "NOAKHALI SADAR",
BEGUMGANJ = "BEGUMGANJ",
CHATKHIL = "CHATKHIL",
COMPANYGANJ = "COMPANYGANJ",
SHENBAG = "SHENBAG",
HATIA = "HATIA",
KOBIRHAT = "KOBIRHAT",
SONAIMURI = "SONAIMURI",
SUBORNO CHAR = "SUBORNO CHAR",
RANGAMATI SADAR = "RANGAMATI SADAR",
BELAICHHARI = "BELAICHHARI",
BAGAICHHARI = "BAGAICHHARI",
BARKAL = "BARKAL",
JURAICHHARI = "JURAICHHARI",
RAJASTHALI = "RAJASTHALI",
KAPTAI = "KAPTAI",
LANGADU = "LANGADU",
NANNERCHAR = "NANNERCHAR",
KAUKHALI = "KAUKHALI",
DHAMRAI = "DHAMRAI",
DOHAR = "DOHAR",
KERANIGANJ = "KERANIGANJ",
NAWABGANJ = "NAWABGANJ",
SAVAR = "SAVAR",
FARIDPUR SADAR = "FARIDPUR SADAR",
BOALMARI = "BOALMARI",
ALFADANGA = "ALFADANGA",
MADHUKHALI = "MADHUKHALI",
BHANGA = "BHANGA",
NAGARKANDA = "NAGARKANDA",
CHARBHADRASAN = "CHARBHADRASAN",
SADARPUR = "SADARPUR",
SHALTHA = "SHALTHA",
GAZIPUR SADAR-JOYDEBPUR = "GAZIPUR SADAR-JOYDEBPUR",
KALIAKIOR = "KALIAKIOR",
KAPASIA = "KAPASIA",
SRIPUR = "SRIPUR",
KALIGANJ = "KALIGANJ",
TONGI = "TONGI",
GOPALGANJ SADAR = "GOPALGANJ SADAR",
KASHIANI = "KASHIANI",
KOTALIPARA = "KOTALIPARA",
MUKSUDPUR = "MUKSUDPUR",
TUNGIPARA = "TUNGIPARA",
DEWANGANJ = "DEWANGANJ",
BAKSIGANJ = "BAKSIGANJ",
ISLAMPUR = "ISLAMPUR",
JAMALPUR SADAR = "JAMALPUR SADAR",
MADARGANJ = "MADARGANJ",
MELANDAHA = "MELANDAHA",
SARISHABARI = "SARISHABARI",
NARUNDI POLICE I.C = "NARUNDI POLICE I.C",
ASTAGRAM = "ASTAGRAM",
BAJITPUR = "BAJITPUR",
BHAIRAB = "BHAIRAB",
HOSSAINPUR = "HOSSAINPUR",
ITNA = "ITNA",
KARIMGANJ = "KARIMGANJ",
KATIADI = "KATIADI",
KISHOREGANJ SADAR = "KISHOREGANJ SADAR",
KULIARCHAR = "KULIARCHAR",
MITHAMAIN = "MITHAMAIN",
NIKLI = "NIKLI",
PAKUNDIA = "PAKUNDIA",
TARAIL = "TARAIL",
MADARIPUR SADAR = "MADARIPUR SADAR",
KALKINI = "KALKINI",
RAJOIR = "RAJOIR",
SHIBCHAR = "SHIBCHAR",
MANIKGANJ SADAR = "MANIKGANJ SADAR",
SINGAIR = "SINGAIR",
SHIBALAYA = "SHIBALAYA",
SATURIA = "SATURIA",
HARIRAMPUR = "HARIRAMPUR",
GHIOR = "GHIOR",
DAULATPUR = "DAULATPUR",
LOHAJANG = "LOHAJANG",
SREENAGAR = "SREENAGAR",
MUNSHIGANJ SADAR = "MUNSHIGANJ SADAR",
SIRAJDIKHAN = "SIRAJDIKHAN",
TONGIBARI = "TONGIBARI",
GAZARIA = "GAZARIA",
BHALUKA = "BHALUKA",
TRISHAL = "TRISHAL",
HALUAGHAT = "HALUAGHAT",
MUKTAGACHHA = "MUKTAGACHHA",
DHOBAURA = "DHOBAURA",
FULBARIA = "FULBARIA",
GAFFARGAON = "GAFFARGAON",
GAURIPUR = "GAURIPUR",
ISHWARGANJ = "ISHWARGANJ",
MYMENSINGH SADAR = "MYMENSINGH SADAR",
NANDAIL = "NANDAIL",
PHULPUR = "PHULPUR",
ARAIHAZAR = "ARAIHAZAR",
SONARGAON = "SONARGAON",
BANDAR = "BANDAR",
NARYANGANJ SADAR = "NARYANGANJ SADAR",
RUPGANJ = "RUPGANJ",
SIDDIRGONJ = "SIDDIRGONJ",
BELABO = "BELABO",
MONOHARDI = "MONOHARDI",
NARSINGDI SADAR = "NARSINGDI SADAR",
PALASH = "PALASH",
RAIPURA, NARSINGDI = "RAIPURA, NARSINGDI",
SHIBPUR = "SHIBPUR",
KENDUA UPAZILLA = "KENDUA UPAZILLA",
ATPARA UPAZILLA = "ATPARA UPAZILLA",
BARHATTA UPAZILLA = "BARHATTA UPAZILLA",
DURGAPUR UPAZILLA = "DURGAPUR UPAZILLA",
KALMAKANDA UPAZILLA = "KALMAKANDA UPAZILLA",
MADAN UPAZILLA = "MADAN UPAZILLA",
MOHANGANJ UPAZILLA = "MOHANGANJ UPAZILLA",
NETRAKONA-S UPAZILLA = "NETRAKONA-S UPAZILLA",
PURBADHALA UPAZILLA = "PURBADHALA UPAZILLA",
KHALIAJURI UPAZILLA = "KHALIAJURI UPAZILLA",
BALIAKANDI = "BALIAKANDI",
GOALANDAGHAT = "GOALANDAGHAT",
PANGSHA = "PANGSHA",
KALUKHALI = "KALUKHALI",
RAJBARI SADAR = "RAJBARI SADAR",
SHARIATPUR SADAR -PALONG = "SHARIATPUR SADAR -PALONG",
DAMUDYA = "DAMUDYA",
NARIA = "NARIA",
JAJIRA = "JAJIRA",
BHEDARGANJ = "BHEDARGANJ",
GOSAIRHAT = "GOSAIRHAT",
JHENAIGATI = "JHENAIGATI",
NAKLA = "NAKLA",
NALITABARI = "NALITABARI",
SHERPUR SADAR = "SHERPUR SADAR",
SREEBARDI = "SREEBARDI",
TANGAIL SADAR = "TANGAIL SADAR",
SAKHIPUR = "SAKHIPUR",
BASAIL = "BASAIL",
MADHUPUR = "MADHUPUR",
GHATAIL = "GHATAIL",
KALIHATI = "KALIHATI",
NAGARPUR = "NAGARPUR",
MIRZAPUR = "MIRZAPUR",
GOPALPUR = "GOPALPUR",
DELDUAR = "DELDUAR",
BHUAPUR = "BHUAPUR",
DHANBARI = "DHANBARI",
BAGERHAT SADAR = "BAGERHAT SADAR",
CHITALMARI = "CHITALMARI",
FAKIRHAT = "FAKIRHAT",
KACHUA = "KACHUA",
MOLLAHAT = "MOLLAHAT",
MONGLA = "MONGLA",
MORRELGANJ = "MORRELGANJ",
RAMPAL = "RAMPAL",
SARANKHOLA = "SARANKHOLA",
DAMURHUDA = "DAMURHUDA",
CHUADANGA-S = "CHUADANGA-S",
JIBANNAGAR = "JIBANNAGAR",
ALAMDANGA = "ALAMDANGA",
ABHAYNAGAR = "ABHAYNAGAR",
KESHABPUR = "KESHABPUR",
BAGHERPARA = "BAGHERPARA",
JESSORE SADAR = "JESSORE SADAR",
CHAUGACHHA = "CHAUGACHHA",
MANIRAMPUR = "MANIRAMPUR",
JHIKARGACHHA = "JHIKARGACHHA",
SHARSHA = "SHARSHA",
JHENAIDAH SADAR = "JHENAIDAH SADAR",
MAHESHPUR = "MAHESHPUR",
KALIGANJ = "KALIGANJ",
KOTCHANDPUR = "KOTCHANDPUR",
SHAILKUPA = "SHAILKUPA",
HARINAKUNDA = "HARINAKUNDA",
TEROKHADA = "TEROKHADA",
BATIAGHATA = "BATIAGHATA",
DACOPE = "DACOPE",
DUMURIA = "DUMURIA",
DIGHALIA = "DIGHALIA",
KOYRA = "KOYRA",
PAIKGACHHA = "PAIKGACHHA",
PHULTALA = "PHULTALA",
RUPSA = "RUPSA",
KUSHTIA SADAR = "KUSHTIA SADAR",
KUMARKHALI = "KUMARKHALI",
DAULATPUR = "DAULATPUR",
MIRPUR = "MIRPUR",
BHERAMARA = "BHERAMARA",
KHOKSA = "KHOKSA",
MAGURA SADAR = "MAGURA SADAR",
MOHAMMADPUR = "MOHAMMADPUR",
SHALIKHA = "SHALIKHA",
SREEPUR = "SREEPUR",
ANGNI = "ANGNI",
MUJIB NAGAR = "MUJIB NAGAR",
MEHERPUR-S = "MEHERPUR-S",
NARAIL-S UPAZILLA = "NARAIL-S UPAZILLA",
LOHAGARA UPAZILLA = "LOHAGARA UPAZILLA",
KALIA UPAZILLA = "KALIA UPAZILLA",
SATKHIRA SADAR = "SATKHIRA SADAR",
ASSASUNI = "ASSASUNI",
DEBHATA = "DEBHATA",
TALA = "TALA",
KALAROA = "KALAROA",
KALIGANJ = "KALIGANJ",
SHYAMNAGAR = "SHYAMNAGAR",
ADAMDIGHI = "ADAMDIGHI",
BOGRA SADAR = "BOGRA SADAR",
SHERPUR = "SHERPUR",
DHUNAT = "DHUNAT",
DHUPCHANCHIA = "DHUPCHANCHIA",
GABTALI = "GABTALI",
KAHALOO = "KAHALOO",
NANDIGRAM = "NANDIGRAM",
SAHAJANPUR = "SAHAJANPUR",
SARIAKANDI = "SARIAKANDI",
SHIBGANJ = "SHIBGANJ",
SONATALA = "SONATALA",
JOYPURHAT S = "JOYPURHAT S",
AKKELPUR = "AKKELPUR",
KALAI = "KALAI",
KHETLAL = "KHETLAL",
PANCHBIBI = "PANCHBIBI",
NAOGAON SADAR = "NAOGAON SADAR",
MOHADEVPUR = "MOHADEVPUR",
MANDA = "MANDA",
NIAMATPUR = "NIAMATPUR",
ATRAI = "ATRAI",
RANINAGAR = "RANINAGAR",
PATNITALA = "PATNITALA",
DHAMOIRHAT = "DHAMOIRHAT",
SAPAHAR = "SAPAHAR",
PORSHA = "PORSHA",
BADALGACHHI = "BADALGACHHI",
NATORE SADAR = "NATORE SADAR",
BARAIGRAM = "BARAIGRAM",
BAGATIPARA = "BAGATIPARA",
LALPUR = "LALPUR",
NATORE SADAR = "NATORE SADAR",
BARAIGRAM = "BARAIGRAM",
BHOLAHAT = "BHOLAHAT",
GOMASTAPUR = "GOMASTAPUR",
NACHOLE = "NACHOLE",
NAWABGANJ SADAR = "NAWABGANJ SADAR",
SHIBGANJ = "SHIBGANJ",
ATGHARIA = "ATGHARIA",
BERA = "BERA",
BHANGURA = "BHANGURA",
CHATMOHAR = "CHATMOHAR",
FARIDPUR = "FARIDPUR",
ISHWARDI = "ISHWARDI",
PABNA SADAR = "PABNA SADAR",
SANTHIA = "SANTHIA",
SUJANAGAR = "SUJANAGAR",
BAGHA = "BAGHA",
BAGMARA = "BAGMARA",
CHARGHAT = "CHARGHAT",
DURGAPUR = "DURGAPUR",
GODAGARI = "GODAGARI",
MOHANPUR = "MOHANPUR",
PABA = "PABA",
PUTHIA = "PUTHIA",
TANORE = "TANORE",
SIRAJGANJ SADAR = "SIRAJGANJ SADAR",
BELKUCHI = "BELKUCHI",
CHAUHALI = "CHAUHALI",
KAMARKHANDA = "KAMARKHANDA",
KAZIPUR = "KAZIPUR",
RAIGANJ = "RAIGANJ",
SHAHJADPUR = "SHAHJADPUR",
TARASH = "TARASH",
ULLAHPARA = "ULLAHPARA",
BIRAMPUR = "BIRAMPUR",
BIRGANJ = "BIRGANJ",
BIRAL = "BIRAL",
BOCHAGANJ = "BOCHAGANJ",
CHIRIRBANDAR = "CHIRIRBANDAR",
PHULBARI = "PHULBARI",
GHORAGHAT = "GHORAGHAT",
HAKIMPUR = "HAKIMPUR",
KAHAROLE = "KAHAROLE",
KHANSAMA = "KHANSAMA",
DINAJPUR SADAR = "DINAJPUR SADAR",
NAWABGANJ = "NAWABGANJ",
PARBATIPUR = "PARBATIPUR",
FULCHHARI = "FULCHHARI",
GAIBANDHA SADAR = "GAIBANDHA SADAR",
GOBINDAGANJ = "GOBINDAGANJ",
PALASHBARI = "PALASHBARI",
SADULLAPUR = "SADULLAPUR",
SAGHATA = "SAGHATA",
SUNDARGANJ = "SUNDARGANJ",
KURIGRAM SADAR = "KURIGRAM SADAR",
NAGESHWARI = "NAGESHWARI",
BHURUNGAMARI = "BHURUNGAMARI",
PHULBARI = "PHULBARI",
RAJARHAT = "RAJARHAT",
ULIPUR = "ULIPUR",
CHILMARI = "CHILMARI",
ROWMARI = "ROWMARI",
CHAR RAJIBPUR = "CHAR RAJIBPUR",
LALMANIRHAT SADAR = "LALMANIRHAT SADAR",
ADITMARI = "ADITMARI",
KALIGANJ = "KALIGANJ",
HATIBANDHA = "HATIBANDHA",
PATGRAM = "PATGRAM",
NILPHAMARI SADAR = "NILPHAMARI SADAR",
SAIDPUR = "SAIDPUR",
JALDHAKA = "JALDHAKA",
KISHOREGANJ = "KISHOREGANJ",
DOMAR = "DOMAR",
DIMLA = "DIMLA",
PANCHAGARH SADAR = "PANCHAGARH SADAR",
DEBIGANJ = "DEBIGANJ",
BODA = "BODA",
ATWARI = "ATWARI",
TETULIA = "TETULIA",
BADARGANJ = "BADARGANJ",
MITHAPUKUR = "MITHAPUKUR",
GANGACHARA = "GANGACHARA",
KAUNIA = "KAUNIA",
RANGPUR SADAR = "RANGPUR SADAR",
PIRGACHHA = "PIRGACHHA",
PIRGANJ = "PIRGANJ",
TARAGANJ = "TARAGANJ",
THAKURGAON SADAR = "THAKURGAON SADAR",
PIRGANJ = "PIRGANJ",
BALIADANGI = "BALIADANGI",
HARIPUR = "HARIPUR",
RANISANKAIL = "RANISANKAIL",
AJMIRIGANJ = "AJMIRIGANJ",
BANIACHANG = "BANIACHANG",
BAHUBAL = "BAHUBAL",
CHUNARUGHAT = "CHUNARUGHAT",
HABIGANJ SADAR = "HABIGANJ SADAR",
LAKHAI = "LAKHAI",
MADHABPUR = "MADHABPUR",
NABIGANJ = "NABIGANJ",
SHAISTAGONJ = "SHAISTAGONJ",
MOULVIBAZAR SADAR = "MOULVIBAZAR SADAR",
BARLEKHA = "BARLEKHA",
JURI = "JURI",
KAMALGANJ = "KAMALGANJ",
KULAURA = "KULAURA",
RAJNAGAR = "RAJNAGAR",
SREEMANGAL = "SREEMANGAL",
BISHWAMVARPUR = "BISHWAMVARPUR",
CHHATAK = "CHHATAK",
DERAI = "DERAI",
DHARAMPASHA = "DHARAMPASHA",
DOWARABAZAR = "DOWARABAZAR",
JAGANNATHPUR = "JAGANNATHPUR",
JAMALGANJ = "JAMALGANJ",
SULLA = "SULLA",
SUNAMGANJ SADAR = "SUNAMGANJ SADAR",
SHANTHIGANJ = "SHANTHIGANJ",
TAHIRPUR = "TAHIRPUR",
SYLHET SADAR = "SYLHET SADAR",
BEANIBAZAR = "BEANIBAZAR",
BISHWANATH = "BISHWANATH",
DAKSHIN SURMA = "DAKSHIN SURMA",
BALAGANJ = "BALAGANJ",
COMPANIGANJ = "COMPANIGANJ",
FENCHUGANJ = "FENCHUGANJ",
GOLAPGANJ = "GOLAPGANJ",
GOWAINGHAT = "GOWAINGHAT",
JAINTIAPUR = "JAINTIAPUR",
KANAIGHAT = "KANAIGHAT",
ZAKIGANJ = "ZAKIGANJ",
NOBIGONJ = "NOBIGONJ",
EIDGAON = "EIDGAON",
MODHYANAGAR = "MODHYANAGAR",
DASAR = "DASAR",
